ಅಂಕ	ಅ ಂ ಕ |
ಅಂಕಗಳನ್ನು	ಅ ಂ ಕ ಗ ಳ ನ ್ ನ ು |
ಅಂಕಲೇಶ್ವರ	ಅ ಂ ಕ ಲ ೇ ಶ ್ ವ ರ |
ಅಂಕೋಲ	ಅ ಂ ಕ ೋ ಲ |
ಅಂಕೋಲಾ	ಅ ಂ ಕ ೋ ಲ ಾ |
ಅಂಗ	ಅ ಂ ಗ |
ಅಂಗಡಿ	ಅ ಂ ಗ ಡ ಿ |
ಅಂಗಣ	ಅ ಂ ಗ ಣ |
ಅಂಗಳ	ಅ ಂ ಗ ಳ |
ಅಂಗಳು	ಅ ಂ ಗ ಳ ು |
ಅಂಗುಲ	ಅ ಂ ಗ ು ಲ |
ಅಂಗೈ	ಅ ಂ ಗ ೈ |
ಅಂಜು	ಅ ಂ ಜ ು |
ಅಂತ	ಅ ಂ ತ |
ಅಂತರ	ಅ ಂ ತ ರ |
ಅಂತರಂಗ	ಅ ಂ ತ ರ ಂ ಗ |
ಅಂತರರಾಷ್ಟ್ರೀಯ	ಅ ಂ ತ ರ ರ ಾ ಷ ್ ಟ ್ ರ ೀ ಯ |
ಅಂತಹ	ಅ ಂ ತ ಹ |
ಅಂತಿಮ	ಅ ಂ ತ ಿ ಮ |
ಅಂತ್ಯ	ಅ ಂ ತ ್ ಯ |
ಅಂಥ	ಅ ಂ ಥ |
ಅಂದ	ಅ ಂ ದ |
ಅಂದರೆ	ಅ ಂ ದ ರ ೆ |
ಅಂದಿನ	ಅ ಂ ದ ಿ ನ |
ಅಂದು	ಅ ಂ ದ ು |
ಅಂದ್ರೆ	ಅ ಂ ದ ್ ರ ೆ |
ಅಂಬರೀಶ್	ಅ ಂ ಬ ರ ೀ ಶ ್ |
ಅಂಬಲಿ	ಅ ಂ ಬ ಲ ಿ |
ಅಂಬಾಲಾ	ಅ ಂ ಬ ಾ ಲ ಾ |
ಅಂಬಿಕಾಪುರ	ಅ ಂ ಬ ಿ ಕ ಾ ಪ ು ರ |
ಅಂಶ	ಅ ಂ ಶ |
ಅಂಶುಮನ್	ಅ ಂ ಶ ು ಮ ನ ್ |
ಅಕಬರಪುರ	ಅ ಕ ಬ ರ ಪ ು ರ |
ಅಕ್ಕಮಹಾದೇವಿ	ಅ ಕ ್ ಕ ಮ ಹ ಾ ದ ೇ ವ ಿ |
ಅಕ್ಕಿ	ಅ ಕ ್ ಕ ಿ |
ಅಕ್ಕಿಯ	ಅ ಕ ್ ಕ ಿ ಯ |
ಅಕ್ಟೋಬರ್	ಅ ಕ ್ ಟ ೋ ಬ ರ ್ |
ಅಕ್ತರ್	ಅ ಕ ್ ತ ರ ್ |
ಅಕ್ರಂ	ಅ ಕ ್ ರ ಂ |
ಅಕ್ರಮ	ಅ ಕ ್ ರ ಮ |
ಅಕ್ಷಯ	ಅ ಕ ್ ಷ ಯ |
ಅಕ್ಷರ	ಅ ಕ ್ ಷ ರ |
ಅಕ್ಷರಗಳ	ಅ ಕ ್ ಷ ರ ಗ ಳ |
ಅಖಿಲ	ಅ ಖ ಿ ಲ |
ಅಖ್ತರ್	ಅ ಖ ್ ತ ರ ್ |
ಅಗತ್ಯ	ಅ ಗ ತ ್ ಯ |
ಅಗರವಾಲ್	ಅ ಗ ರ ವ ಾ ಲ ್ |
ಅಗರ್	ಅ ಗ ರ ್ |
ಅಗರ್ಕರ್	ಅ ಗ ರ ್ ಕ ರ ್ |
ಅಗಲದ	ಅ ಗ ಲ ದ |
ಅಗಲವಾಗಿದೆ	ಅ ಗ ಲ ವ ಾ ಗ ಿ ದ ೆ |
ಅಗಸ	ಅ ಗ ಸ |
ಅಗಾಸ್ಸಿ	ಅ ಗ ಾ ಸ ್ ಸ ಿ |
ಅಗ್ರ	ಅ ಗ ್ ರ |
ಅಚ್ಚರಿ	ಅ ಚ ್ ಚ ರ ಿ |
ಅಜಯ್	ಅ ಜ ಯ ್ |
ಅಜಿತ	ಅ ಜ ಿ ತ |
ಅಜಿಮ್	ಅ ಜ ಿ ಮ ್ |
ಅಜುರುದ್ದಿನ್	ಅ ಜ ು ರ ು ದ ್ ದ ಿ ನ ್ |
ಅಜೇಯ	ಅ ಜ ೇ ಯ |
ಅಜ್ಜ	ಅ ಜ ್ ಜ |
ಅಜ್ಜಿ	ಅ ಜ ್ ಜ ಿ |
ಅಜ್ಜಿಯ	ಅ ಜ ್ ಜ ಿ ಯ |
ಅಜ್ಜಿಯಂದಿರು	ಅ ಜ ್ ಜ ಿ ಯ ಂ ದ ಿ ರ ು |
ಅಜ್ಮೇರ್	ಅ ಜ ್ ಮ ೇ ರ ್ |
ಅಟಲ್	ಅ ಟ ಲ ್ |
ಅಟ್ಟ	ಅ ಟ ್ ಟ |
ಅಟ್ಟುಪಟ್ಟು	ಅ ಟ ್ ಟ ು ಪ ಟ ್ ಟ ು |
ಅಡಿ	ಅ ಡ ಿ |
ಅಡಿಗೆ	ಅ ಡ ಿ ಗ ೆ |
ಅಡ್ವಾಣಿ	ಅ ಡ ್ ವ ಾ ಣ ಿ |
ಅಡ್ವಾನಿ	ಅ ಡ ್ ವ ಾ ನ ಿ |
ಅಣ್ಣ	ಅ ಣ ್ ಣ |
ಅತಿ	ಅ ತ ಿ |
ಅತಿಯಾಗಿ	ಅ ತ ಿ ಯ ಾ ಗ ಿ |
ಅತಿಯಾದ	ಅ ತ ಿ ಯ ಾ ದ |
ಅತ್ತೆ	ಅ ತ ್ ತ ೆ |
ಅತ್ಯಂತ	ಅ ತ ್ ಯ ಂ ತ |
ಅತ್ಯುತ್ತಮ	ಅ ತ ್ ಯ ು ತ ್ ತ ಮ |
ಅತ್ರಿಟನ್	ಅ ತ ್ ರ ಿ ಟ ನ ್ |
ಅಥವಾ	ಅ ಥ ವ ಾ |
ಅದಕ್ಕಾಗಿ	ಅ ದ ಕ ್ ಕ ಾ ಗ ಿ |
ಅದಕ್ಕೆ	ಅ ದ ಕ ್ ಕ ೆ |
ಅದನ್ನು	ಅ ದ ನ ್ ನ ು |
ಅದರ	ಅ ದ ರ |
ಅದರಂತೆ	ಅ ದ ರ ಂ ತ ೆ |
ಅದು	ಅ ದ ು |
ಅದ್ಭುತ	ಅ ದ ್ ಭ ು ತ |
ಅಧಿಕ	ಅ ಧ ಿ ಕ |
ಅಧಿಕಾರ	ಅ ಧ ಿ ಕ ಾ ರ |
ಅಧಿಕಾರಿ	ಅ ಧ ಿ ಕ ಾ ರ ಿ |
ಅಧಿಕೃತ	ಅ ಧ ಿ ಕ ೃ ತ |
ಅಧಿವೇಶನ	ಅ ಧ ಿ ವ ೇ ಶ ನ |
ಅಧ್ಯಕ್ಷ	ಅ ಧ ್ ಯ ಕ ್ ಷ |
ಅಧ್ಯಯನ	ಅ ಧ ್ ಯ ಯ ನ |
ಅಧ್ಯಾಯ	ಅ ಧ ್ ಯ ಾ ಯ |
ಅನಂತನಾಗ್	ಅ ನ ಂ ತ ನ ಾ ಗ ್ |
ಅನಂತಪುರ	ಅ ನ ಂ ತ ಪ ು ರ |
ಅನಂತಮೂರ್ತಿ	ಅ ನ ಂ ತ ಮ ೂ ರ ್ ತ ಿ |
ಅನಂತರ	ಅ ನ ಂ ತ ರ |
ಅನಾಥ	ಅ ನ ಾ ಥ |
ಅನಿಲ್	ಅ ನ ಿ ಲ ್ |
ಅನಿವಾರ್ಯ	ಅ ನ ಿ ವ ಾ ರ ್ ಯ |
ಅನಿಸು	ಅ ನ ಿ ಸ ು |
ಅನುಕೂಲ	ಅ ನ ು ಕ ೂ ಲ |
ಅನುಪಮ್	ಅ ನ ು ಪ ಮ ್ |
ಅನುಭವ	ಅ ನ ು ಭ ವ |
ಅನುಭವಿಸು	ಅ ನ ು ಭ ವ ಿ ಸ ು |
ಅನುಮತಿ	ಅ ನ ು ಮ ತ ಿ |
ಅನುಮಾನ	ಅ ನ ು ಮ ಾ ನ |
ಅನುವಾದ	ಅ ನ ು ವ ಾ ದ |
ಅನುಸರಿಸು	ಅ ನ ು ಸ ರ ಿ ಸ ು |
ಅನುಸೂಯ	ಅ ನ ು ಸ ೂ ಯ |
ಅನೇಕ	ಅ ನ ೇ ಕ |
ಅನ್ನ	ಅ ನ ್ ನ |
ಅನ್ನು	ಅ ನ ್ ನ ು |
ಅನ್ಯಾಯ	ಅ ನ ್ ಯ ಾ ಯ |
ಅನ್ವರ್	ಅ ನ ್ ವ ರ ್ |
ಅಪರೂಪ	ಅ ಪ ರ ೂ ಪ |
ಅಪಾಯ	ಅ ಪ ಾ ಯ |
ಅಪಾರ	ಅ ಪ ಾ ರ |
ಅಪ್ಪ	ಅ ಪ ್ ಪ |
ಅಫ್ಜಲ್	ಅ ಫ ್ ಜ ಲ ್ |
ಅಫ್ರಿದಿ	ಅ ಫ ್ ರ ಿ ದ ಿ |
ಅಬೊಹರ	ಅ ಬ ೊ ಹ ರ |
ಅಬ್ಗುಲ್	ಅ ಬ ್ ಗ ು ಲ ್ |
ಅಬ್ದುಲ್	ಅ ಬ ್ ದ ು ಲ ್ |
ಅಬ್ಬಾಸ್	ಅ ಬ ್ ಬ ಾ ಸ ್ |
ಅಭಯ್	ಅ ಭ ಯ ್ |
ಅಭಿನವ	ಅ ಭ ಿ ನ ವ |
ಅಭಿಪ್ರಾಯ	ಅ ಭ ಿ ಪ ್ ರ ಾ ಯ |
ಅಭಿಮಾನಿ	ಅ ಭ ಿ ಮ ಾ ನ ಿ |
ಅಭಿವೃದ್ಧಿ	ಅ ಭ ಿ ವ ೃ ದ ್ ಧ ಿ |
ಅಭಿವ್ಯಕ್ತಿ	ಅ ಭ ಿ ವ ್ ಯ ಕ ್ ತ ಿ |
ಅಭಿಷೇಕ್	ಅ ಭ ಿ ಷ ೇ ಕ ್ |
ಅಭ್ಯರ್ಥಿ	ಅ ಭ ್ ಯ ರ ್ ಥ ಿ |
ಅಭ್ಯಾಸ	ಅ ಭ ್ ಯ ಾ ಸ |
ಅಮಜತ್	ಅ ಮ ಜ ತ ್ |
ಅಮರನಾಥ್	ಅ ಮ ರ ನ ಾ ಥ ್ |
ಅಮರಾವತಿ	ಅ ಮ ರ ಾ ವ ತ ಿ |
ಅಮರೀಶ್	ಅ ಮ ರ ೀ ಶ ್ |
ಅಮರ್	ಅ ಮ ರ ್ |
ಅಮರ್ತ್ಯ	ಅ ಮ ರ ್ ತ ್ ಯ |
ಅಮಿತಾಬ್	ಅ ಮ ಿ ತ ಾ ಬ ್ |
ಅಮೀನ್	ಅ ಮ ೀ ನ ್ |
ಅಮೂಲ್ಯ	ಅ ಮ ೂ ಲ ್ ಯ |
ಅಮೃತಸರ	ಅ ಮ ೃ ತ ಸ ರ |
ಅಮ್ಮ	ಅ ಮ ್ ಮ |
ಅಯೋಧ್ಯ	ಅ ಯ ೋ ಧ ್ ಯ |
ಅಯ್ಯಂಗಾರ್	ಅ ಯ ್ ಯ ಂ ಗ ಾ ರ ್ |
ಅಯ್ಯರ್	ಅ ಯ ್ ಯ ರ ್ |
ಅರಕಲಗೂಡು	ಅ ರ ಕ ಲ ಗ ೂ ಡ ು |
ಅರಚುತ್ತವೆ	ಅ ರ ಚ ು ತ ್ ತ ವ ೆ |
ಅರಣ್ಯ	ಅ ರ ಣ ್ ಯ |
ಅರಮನೆ	ಅ ರ ಮ ನ ೆ |
ಅರವತ್ತನಾಲ್ಕು	ಅ ರ ವ ತ ್ ತ ನ ಾ ಲ ್ ಕ ು |
ಅರವತ್ತಮೂರು	ಅ ರ ವ ತ ್ ತ ಮ ೂ ರ ು |
ಅರವತ್ತಾರು	ಅ ರ ವ ತ ್ ತ ಾ ರ ು |
ಅರವತ್ತು	ಅ ರ ವ ತ ್ ತ ು |
ಅರವತ್ತೆಂಟು	ಅ ರ ವ ತ ್ ತ ೆ ಂ ಟ ು |
ಅರವತ್ತೆರಡು	ಅ ರ ವ ತ ್ ತ ೆ ರ ಡ ು |
ಅರವತ್ತೇಳು	ಅ ರ ವ ತ ್ ತ ೇ ಳ ು |
ಅರವತ್ತೈದು	ಅ ರ ವ ತ ್ ತ ೈ ದ ು |
ಅರವತ್ತೊಂದು	ಅ ರ ವ ತ ್ ತ ೊ ಂ ದ ು |
ಅರವತ್ತೊಂಬತ್ತು	ಅ ರ ವ ತ ್ ತ ೊ ಂ ಬ ತ ್ ತ ು |
ಅರವಿಂದ್	ಅ ರ ವ ಿ ಂ ದ ್ |
ಅರಸ	ಅ ರ ಸ |
ಅರಸೀಕೆರೆ	ಅ ರ ಸ ೀ ಕ ೆ ರ ೆ |
ಅರಸ್	ಅ ರ ಸ ್ |
ಅರಿ	ಅ ರ ಿ |
ಅರಿತುಕೊಳ್ಳಬೇಕು	ಅ ರ ಿ ತ ು ಕ ೊ ಳ ್ ಳ ಬ ೇ ಕ ು |
ಅರಿವು	ಅ ರ ಿ ವ ು |
ಅರುಣ್	ಅ ರ ು ಣ ್ |
ಅರುನ್	ಅ ರ ು ನ ್ |
ಅರೋರಾ	ಅ ರ ೋ ರ ಾ |
ಅರ್ಜಿ	ಅ ರ ್ ಜ ಿ |
ಅರ್ಜುನ್	ಅ ರ ್ ಜ ು ನ ್ |
ಅರ್ಥ	ಅ ರ ್ ಥ |
ಅರ್ಧ	ಅ ರ ್ ಧ |
ಅರ್ಧಗಂಟೆಯಲ್ಲಿ	ಅ ರ ್ ಧ ಗ ಂ ಟ ೆ ಯ ಲ ್ ಲ ಿ |
ಅರ್ಹ	ಅ ರ ್ ಹ |
ಅಲವಾರ್	ಅ ಲ ವ ಾ ರ ್ |
ಅಲಿ	ಅ ಲ ಿ |
ಅಲೀಗಢ್	ಅ ಲ ೀ ಗ ಢ ್ |
ಅಲೋಕ್	ಅ ಲ ೋ ಕ ್ |
ಅಲ್ಪ	ಅ ಲ ್ ಪ |
ಅಲ್ಬರ್ಟ್	ಅ ಲ ್ ಬ ರ ್ ಟ ್ |
ಅಲ್ಲ	ಅ ಲ ್ ಲ |
ಅಲ್ಲದೆ	ಅ ಲ ್ ಲ ದ ೆ |
ಅಲ್ಲವೆ	ಅ ಲ ್ ಲ ವ ೆ |
ಅಲ್ಲಿ	ಅ ಲ ್ ಲ ಿ |
ಅಲ್ಲೂ	ಅ ಲ ್ ಲ ೂ |
ಅಲ್ಲೇ	ಅ ಲ ್ ಲ ೇ |
ಅಳತೆ	ಅ ಳ ತ ೆ |
ಅಳಿಯ	ಅ ಳ ಿ ಯ |
ಅಳುತ್ತಿದೆ	ಅ ಳ ು ತ ್ ತ ಿ ದ ೆ |
ಅವಕಾಶ	ಅ ವ ಕ ಾ ಶ |
ಅವಧಿ	ಅ ವ ಧ ಿ |
ಅವನ	ಅ ವ ನ |
ಅವನು	ಅ ವ ನ ು |
ಅವನ್ನು	ಅ ವ ನ ್ ನ ು |
ಅವರ	ಅ ವ ರ |
ಅವರು	ಅ ವ ರ ು |
ಅವರೆಲ್ಲ	ಅ ವ ರ ೆ ಲ ್ ಲ |
ಅವರೆಲ್ಲರ	ಅ ವ ರ ೆ ಲ ್ ಲ ರ |
ಅವಳ	ಅ ವ ಳ |
ಅವಳಿಗೆ	ಅ ವ ಳ ಿ ಗ ೆ |
ಅವಳು	ಅ ವ ಳ ು |
ಅವಶ್ಯಕತೆ	ಅ ವ ಶ ್ ಯ ಕ ತ ೆ |
ಅವು	ಅ ವ ು |
ಅವ್ವ	ಅ ವ ್ ವ |
ಅಶೋಕ	ಅ ಶ ೋ ಕ |
ಅಶ್ವಥ್	ಅ ಶ ್ ವ ಥ ್ |
ಅಶ್ವಿನಿ	ಅ ಶ ್ ವ ಿ ನ ಿ |
ಅಷ್ಟರಲ್ಲಿ	ಅ ಷ ್ ಟ ರ ಲ ್ ಲ ಿ |
ಅಷ್ಟು	ಅ ಷ ್ ಟ ು |
ಅಸಮಾಧಾನ	ಅ ಸ ಮ ಾ ಧ ಾ ನ |
ಅಸಾಧ್ಯ	ಅ ಸ ಾ ಧ ್ ಯ |
ಅಸ್ತಿತ್ವ	ಅ ಸ ್ ತ ಿ ತ ್ ವ |
ಅಹಮದಾಬಾದ್	ಅ ಹ ಮ ದ ಾ ಬ ಾ ದ ್ |
ಅಹಮದ್	ಅ ಹ ಮ ದ ್ |
ಅಹಿಂದ	ಅ ಹ ಿ ಂ ದ |
ಆ	ಆ |
ಆಂಗಲೋಂಗ್	ಆ ಂ ಗ ಲ ೋ ಂ ಗ ್ |
ಆಂಗ್ಲ	ಆ ಂ ಗ ್ ಲ |
ಆಂತರಿಕ	ಆ ಂ ತ ರ ಿ ಕ |
ಆಂಧ್ರಪ್ರದೇಶ್	ಆ ಂ ಧ ್ ರ ಪ ್ ರ ದ ೇ ಶ ್ |
ಆಕರ್ಷಕ	ಆ ಕ ರ ್ ಷ ಕ |
ಆಕಾಶ	ಆ ಕ ಾ ಶ |
ಆಕಾಶದಲ್ಲಿ	ಆ ಕ ಾ ಶ ದ ಲ ್ ಲ ಿ |
ಆಕೆ	ಆ ಕ ೆ |
ಆಗ	ಆ ಗ |
ಆಗಬಹುದು	ಆ ಗ ಬ ಹ ು ದ ು |
ಆಗಲ್ಲ	ಆ ಗ ಲ ್ ಲ |
ಆಗಸ್ಟ್	ಆ ಗ ಸ ್ ಟ ್ |
ಆಗಾ	ಆ ಗ ಾ |
ಆಗಿದೆ	ಆ ಗ ಿ ದ ೆ |
ಆಗಿನ	ಆ ಗ ಿ ನ |
ಆಗು	ಆ ಗ ು |
ಆಗುತ್ತಾಳೆ	ಆ ಗ ು ತ ್ ತ ಾ ಳ ೆ |
ಆಗ್ನೇಯ	ಆ ಗ ್ ನ ೇ ಯ |
ಆಗ್ರಾ	ಆ ಗ ್ ರ ಾ |
ಆಚರಣೆ	ಆ ಚ ರ ಣ ೆ |
ಆಚರಿಸುತ್ತಾರೆ	ಆ ಚ ರ ಿ ಸ ು ತ ್ ತ ಾ ರ ೆ |
ಆಚಾರ	ಆ ಚ ಾ ರ |
ಆಚಾರಗಳನ್ನು	ಆ ಚ ಾ ರ ಗ ಳ ನ ್ ನ ು |
ಆಜಂಮಗಢ್	ಆ ಜ ಂ ಮ ಗ ಢ ್ |
ಆಟ	ಆ ಟ |
ಆಟಗಾರ	ಆ ಟ ಗ ಾ ರ |
ಆಡಬೇಡ	ಆ ಡ ಬ ೇ ಡ |
ಆಡಳಿತ	ಆ ಡ ಳ ಿ ತ |
ಆಡಿದ	ಆ ಡ ಿ ದ |
ಆಡು	ಆ ಡ ು |
ಆತ	ಆ ತ |
ಆತಂಕ	ಆ ತ ಂ ಕ |
ಆತಿಥೇಯ	ಆ ತ ಿ ಥ ೇ ಯ |
ಆತ್ಮ	ಆ ತ ್ ಮ |
ಆತ್ಮಕ್ಕೆ	ಆ ತ ್ ಮ ಕ ್ ಕ ೆ |
ಆತ್ಮವಿಶ್ವಾಸ	ಆ ತ ್ ಮ ವ ಿ ಶ ್ ವ ಾ ಸ |
ಆದಕಾರಣ	ಆ ದ ಕ ಾ ರ ಣ |
ಆದರೂ	ಆ ದ ರ ೂ |
ಆದರೆ	ಆ ದ ರ ೆ |
ಆದರ್ಶ	ಆ ದ ರ ್ ಶ |
ಆದಾಗ್ಯೂ	ಆ ದ ಾ ಗ ್ ಯ ೂ |
ಆದಾಯ	ಆ ದ ಾ ಯ |
ಆದಿಚುಂಚನಗಿರಿ	ಆ ದ ಿ ಚ ು ಂ ಚ ನ ಗ ಿ ರ ಿ |
ಆದಿಲಾಬಾದ್	ಆ ದ ಿ ಲ ಾ ಬ ಾ ದ ್ |
ಆದುದರಿಂದ	ಆ ದ ು ದ ರ ಿ ಂ ದ |
ಆದೇಶ	ಆ ದ ೇ ಶ |
ಆದ್ದರಿಂದ	ಆ ದ ್ ದ ರ ಿ ಂ ದ |
ಆಧಾರ	ಆ ಧ ಾ ರ |
ಆಧುನಿಕ	ಆ ಧ ು ನ ಿ ಕ |
ಆಧ್ಯಾತ್ಮಿಕ	ಆ ಧ ್ ಯ ಾ ತ ್ ಮ ಿ ಕ |
ಆನಂತರ	ಆ ನ ಂ ತ ರ |
ಆನಂದ	ಆ ನ ಂ ದ |
ಆನಂದ್	ಆ ನ ಂ ದ ್ |
ಆನೆಕಲ್	ಆ ನ ೆ ಕ ಲ ್ |
ಆಪ್ತ	ಆ ಪ ್ ತ |
ಆಪ್ತಮಿತ್ರ	ಆ ಪ ್ ತ ಮ ಿ ತ ್ ರ |
ಆಫೀಸಿನಲ್ಲಿ	ಆ ಫ ೀ ಸ ಿ ನ ಲ ್ ಲ ಿ |
ಆಭರಣಗಳಲ್ಲಿ	ಆ ಭ ರ ಣ ಗ ಳ ಲ ್ ಲ ಿ |
ಆಭರಣವಾಗಿದೆ	ಆ ಭ ರ ಣ ವ ಾ ಗ ಿ ದ ೆ |
ಆಮೀರ	ಆ ಮ ೀ ರ |
ಆಮೆ	ಆ ಮ ೆ |
ಆಮೇಲೆ	ಆ ಮ ೇ ಲ ೆ |
ಆಯಾ	ಆ ಯ ಾ |
ಆಯಿಜೋಲ್	ಆ ಯ ಿ ಜ ೋ ಲ ್ |
ಆಯಿತು	ಆ ಯ ಿ ತ ು |
ಆಯೋಗ	ಆ ಯ ೋ ಗ |
ಆಯ್ಕಿಡೋ	ಆ ಯ ್ ಕ ಿ ಡ ೋ |
ಆಯ್ಕೆ	ಆ ಯ ್ ಕ ೆ |
ಆರ	ಆ ರ |
ಆರಂಭ	ಆ ರ ಂ ಭ |
ಆರನೆಯ	ಆ ರ ನ ೆ ಯ |
ಆರನೇ	ಆ ರ ನ ೇ |
ಆರು	ಆ ರ ು |
ಆರುಷಿ	ಆ ರ ು ಷ ಿ |
ಆರೂನೂರು	ಆ ರ ೂ ನ ೂ ರ ು |
ಆರೋಗ್ಯ	ಆ ರ ೋ ಗ ್ ಯ |
ಆರೋಗ್ಯಕ್ಕೆ	ಆ ರ ೋ ಗ ್ ಯ ಕ ್ ಕ ೆ |
ಆರೋಗ್ಯವೂ	ಆ ರ ೋ ಗ ್ ಯ ವ ೂ |
ಆರೋಪ	ಆ ರ ೋ ಪ |
ಆರ್	ಆ ರ ್ |
ಆರ್ತುರ್	ಆ ರ ್ ತ ು ರ ್ |
ಆರ್ಥಿಕ	ಆ ರ ್ ಥ ಿ ಕ |
ಆಲಿ	ಆ ಲ ಿ |
ಆಲೂರು	ಆ ಲ ೂ ರ ು |
ಆಲೋಚನೆ	ಆ ಲ ೋ ಚ ನ ೆ |
ಆಳ	ಆ ಳ |
ಆಳು	ಆ ಳ ು |
ಆವಸ್ಥಿ	ಆ ವ ಸ ್ ಥ ಿ |
ಆಶಯ	ಆ ಶ ಯ |
ಆಶಾಢ	ಆ ಶ ಾ ಢ |
ಆಶಿಷ್	ಆ ಶ ಿ ಷ ್ |
ಆಶ್ಚರ್ಯ	ಆ ಶ ್ ಚ ರ ್ ಯ |
ಆಶ್ರಯ	ಆ ಶ ್ ರ ಯ |
ಆಸಕ್ತಿ	ಆ ಸ ಕ ್ ತ ಿ |
ಆಸನ್	ಆ ಸ ನ ್ |
ಆಸಿಫ್	ಆ ಸ ಿ ಫ ್ |
ಆಸೆ	ಆ ಸ ೆ |
ಆಸ್ತಿ	ಆ ಸ ್ ತ ಿ |
ಆಸ್ತಿಯ	ಆ ಸ ್ ತ ಿ ಯ |
ಆಸ್ಪತ್ರೆ	ಆ ಸ ್ ಪ ತ ್ ರ ೆ |
ಆಹಾರ	ಆ ಹ ಾ ರ |
ಇಂಚು	ಇ ಂ ಚ ು |
ಇಂಜಾಮಾಂ	ಇ ಂ ಜ ಾ ಮ ಾ ಂ |
ಇಂಜಿನಿಯರ್	ಇ ಂ ಜ ಿ ನ ಿ ಯ ರ ್ |
ಇಂಡಿ	ಇ ಂ ಡ ಿ |
ಇಂಡೋರ್	ಇ ಂ ಡ ೋ ರ ್ |
ಇಂಥ	ಇ ಂ ಥ |
ಇಂದಿನ	ಇ ಂ ದ ಿ ನ |
ಇಂದಿರಾ	ಇ ಂ ದ ಿ ರ ಾ |
ಇಂದು	ಇ ಂ ದ ು |
ಇಂದ್ರ	ಇ ಂ ದ ್ ರ |
ಇಂಪು	ಇ ಂ ಪ ು |
ಇಂಫಾಲ್	ಇ ಂ ಫ ಾ ಲ ್ |
ಇಎಎಸ್	ಇ ಎ ಎ ಸ ್ |
ಇಚ್ಛೆ	ಇ ಚ ್ ಛ ೆ |
ಇಟಾರಸೀ	ಇ ಟ ಾ ರ ಸ ೀ |
ಇಟ್ಟು	ಇ ಟ ್ ಟ ು |
ಇಟ್ಟುಕೊಳ್ಳಬೇಕು	ಇ ಟ ್ ಟ ು ಕ ೊ ಳ ್ ಳ ಬ ೇ ಕ ು |
ಇಡಿಯಾಗಿ	ಇ ಡ ಿ ಯ ಾ ಗ ಿ |
ಇಡೀ	ಇ ಡ ೀ |
ಇಡು	ಇ ಡ ು |
ಇಡುತ್ತೇವೆ	ಇ ಡ ು ತ ್ ತ ೇ ವ ೆ |
ಇಡ್ಲಿ	ಇ ಡ ್ ಲ ಿ |
ಇಡ್ಲಿಯನ್ನು	ಇ ಡ ್ ಲ ಿ ಯ ನ ್ ನ ು |
ಇತರ	ಇ ತ ರ |
ಇತರೆ	ಇ ತ ರ ೆ |
ಇತಿಹಾಸ	ಇ ತ ಿ ಹ ಾ ಸ |
ಇತ್ತೀಚೆಗೆ	ಇ ತ ್ ತ ೀ ಚ ೆ ಗ ೆ |
ಇತ್ತು	ಇ ತ ್ ತ ು |
ಇತ್ಯಾದಿ	ಇ ತ ್ ಯ ಾ ದ ಿ |
ಇದಕ್ಕೆ	ಇ ದ ಕ ್ ಕ ೆ |
ಇದಾಯಿ	ಇ ದ ಾ ಯ ಿ |
ಇದು	ಇ ದ ು |
ಇದುಕೀ	ಇ ದ ು ಕ ೀ |
ಇದೆ	ಇ ದ ೆ |
ಇದ್ದ	ಇ ದ ್ ದ |
ಇದ್ದರು	ಇ ದ ್ ದ ರ ು |
ಇದ್ದವರು	ಇ ದ ್ ದ ವ ರ ು |
ಇದ್ದವು	ಇ ದ ್ ದ ವ ು |
ಇದ್ದಾರೆ	ಇ ದ ್ ದ ಾ ರ ೆ |
ಇದ್ದು	ಇ ದ ್ ದ ು |
ಇದ್ದೇ	ಇ ದ ್ ದ ೇ |
ಇನ್ನು	ಇ ನ ್ ನ ು |
ಇನ್ನೂ	ಇ ನ ್ ನ ೂ |
ಇನ್ನೂರು	ಇ ನ ್ ನ ೂ ರ ು |
ಇಪ್ಪತೆಂಟು	ಇ ಪ ್ ಪ ತ ೆ ಂ ಟ ು |
ಇಪ್ಪತೊಂಬತ್ತು	ಇ ಪ ್ ಪ ತ ೊ ಂ ಬ ತ ್ ತ ು |
ಇಪ್ಪತ್ತಮೂರು	ಇ ಪ ್ ಪ ತ ್ ತ ಮ ೂ ರ ು |
ಇಪ್ಪತ್ತಾರು	ಇ ಪ ್ ಪ ತ ್ ತ ಾ ರ ು |
ಇಪ್ಪತ್ತು	ಇ ಪ ್ ಪ ತ ್ ತ ು |
ಇಪ್ಪತ್ತೆರಡು	ಇ ಪ ್ ಪ ತ ್ ತ ೆ ರ ಡ ು |
ಇಪ್ಪತ್ತೇಳು	ಇ ಪ ್ ಪ ತ ್ ತ ೇ ಳ ು |
ಇಪ್ಪತ್ತೈದು	ಇ ಪ ್ ಪ ತ ್ ತ ೈ ದ ು |
ಇಪ್ಪತ್ತೊಂದು	ಇ ಪ ್ ಪ ತ ್ ತ ೊ ಂ ದ ು |
ಇಪ್ಪತ್ನಾಲ್ಕು	ಇ ಪ ್ ಪ ತ ್ ನ ಾ ಲ ್ ಕ ು |
ಇಬ್ಬರು	ಇ ಬ ್ ಬ ರ ು |
ಇಮ್ರಾಂ	ಇ ಮ ್ ರ ಾ ಂ |
ಇಮ್ರಾನ್	ಇ ಮ ್ ರ ಾ ನ ್ |
ಇಮ್ರಾಪೂರ	ಇ ಮ ್ ರ ಾ ಪ ೂ ರ |
ಇಯಾನ್	ಇ ಯ ಾ ನ ್ |
ಇರಬೇಕು	ಇ ರ ಬ ೇ ಕ ು |
ಇರಲು	ಇ ರ ಲ ು |
ಇರು	ಇ ರ ು |
ಇರುತ್ತದೆ	ಇ ರ ು ತ ್ ತ ದ ೆ |
ಇರುತ್ತವೆ	ಇ ರ ು ತ ್ ತ ವ ೆ |
ಇರುವ	ಇ ರ ು ವ |
ಇರುವುದು	ಇ ರ ು ವ ು ದ ು |
ಇರುವೆಗಳು	ಇ ರ ು ವ ೆ ಗ ಳ ು |
ಇಲಾಖೆ	ಇ ಲ ಾ ಖ ೆ |
ಇಲ್ಲ	ಇ ಲ ್ ಲ |
ಇಲ್ಲದೆ	ಇ ಲ ್ ಲ ದ ೆ |
ಇಲ್ಲವಾದರೆ	ಇ ಲ ್ ಲ ವ ಾ ದ ರ ೆ |
ಇಲ್ಲವೆ	ಇ ಲ ್ ಲ ವ ೆ |
ಇಲ್ಲಾಂದ್ರೆ	ಇ ಲ ್ ಲ ಾ ಂ ದ ್ ರ ೆ |
ಇಲ್ಲಿ	ಇ ಲ ್ ಲ ಿ |
ಇಲ್ಲಿಯ	ಇ ಲ ್ ಲ ಿ ಯ |
ಇಳಯ	ಇ ಳ ಯ |
ಇಳಿ	ಇ ಳ ಿ |
ಇವತ್ತು	ಇ ವ ತ ್ ತ ು |
ಇವನು	ಇ ವ ನ ು |
ಇವರ	ಇ ವ ರ |
ಇವರು	ಇ ವ ರ ು |
ಇವು	ಇ ವ ು |
ಇವೆ	ಇ ವ ೆ |
ಇಷ್ಕ	ಇ ಷ ್ ಕ |
ಇಷ್ಟ	ಇ ಷ ್ ಟ |
ಇಷ್ಟು	ಇ ಷ ್ ಟ ು |
ಇಷ್ಟುಹೊತ್ತಿಗೆ	ಇ ಷ ್ ಟ ು ಹ ೊ ತ ್ ತ ಿ ಗ ೆ |
ಈ	ಈ |
ಈಗ	ಈ ಗ |
ಈಚೆ	ಈ ಚ ೆ |
ಈಜು	ಈ ಜ ು |
ಈಟಾನಗರ	ಈ ಟ ಾ ನ ಗ ರ |
ಈತ	ಈ ತ |
ಈರುಳ್ಳಿ	ಈ ರ ು ಳ ್ ಳ ಿ |
ಈರೋಡ್	ಈ ರ ೋ ಡ ್ |
ಈಲಹಾಬಾದ್	ಈ ಲ ಹ ಾ ಬ ಾ ದ ್ |
ಈಳಿಗೆ	ಈ ಳ ಿ ಗ ೆ |
ಈವರೆಗೆ	ಈ ವ ರ ೆ ಗ ೆ |
ಈಶ	ಈ ಶ |
ಈಶಾನ್ಯ	ಈ ಶ ಾ ನ ್ ಯ |
ಉಂಗುರ	ಉ ಂ ಗ ು ರ |
ಉಂಗುರವನ್ನು	ಉ ಂ ಗ ು ರ ವ ನ ್ ನ ು |
ಉಂಟು	ಉ ಂ ಟ ು |
ಉಗಿ	ಉ ಗ ಿ |
ಉಗುರು	ಉ ಗ ು ರ ು |
ಉಜ್ಜು	ಉ ಜ ್ ಜ ು |
ಉಡುಗೊರೆಯಾಗಿ	ಉ ಡ ು ಗ ೊ ರ ೆ ಯ ಾ ಗ ಿ |
ಉಡುತಡಿ	ಉ ಡ ು ತ ಡ ಿ |
ಉಡುಪಿ	ಉ ಡ ು ಪ ಿ |
ಉಣ್ಣೆಯ	ಉ ಣ ್ ಣ ೆ ಯ |
ಉತ್ತಮ	ಉ ತ ್ ತ ಮ |
ಉತ್ತರ	ಉ ತ ್ ತ ರ |
ಉತ್ತರಹಳ್ಳಿ	ಉ ತ ್ ತ ರ ಹ ಳ ್ ಳ ಿ |
ಉತ್ಪಾದನೆ	ಉ ತ ್ ಪ ಾ ದ ನ ೆ |
ಉತ್ಸಾಹ	ಉ ತ ್ ಸ ಾ ಹ |
ಉದಯ್	ಉ ದ ಯ ್ |
ಉದಾಸ್	ಉ ದ ಾ ಸ ್ |
ಉದಾಹರಣೆ	ಉ ದ ಾ ಹ ರ ಣ ೆ |
ಉದಿತ್	ಉ ದ ಿ ತ ್ |
ಉದ್ದ	ಉ ದ ್ ದ |
ಉದ್ದದ	ಉ ದ ್ ದ ದ |
ಉದ್ದನ್ನು	ಉ ದ ್ ದ ನ ್ ನ ು |
ಉದ್ದು	ಉ ದ ್ ದ ು |
ಉದ್ದೇಶ	ಉ ದ ್ ದ ೇ ಶ |
ಉದ್ಯೋಗ	ಉ ದ ್ ಯ ೋ ಗ |
ಉನ್ನತ	ಉ ನ ್ ನ ತ |
ಉನ್ನಾವ	ಉ ನ ್ ನ ಾ ವ |
ಉಪ	ಉ ಪ |
ಉಪಕಾರಿ	ಉ ಪ ಕ ಾ ರ ಿ |
ಉಪಮುಖ್ಯಮಂತ್ರಿ	ಉ ಪ ಮ ು ಖ ್ ಯ ಮ ಂ ತ ್ ರ ಿ |
ಉಪಯೋಗ	ಉ ಪ ಯ ೋ ಗ |
ಉಪಯೋಗಿಸುತ್ತಿರುವ	ಉ ಪ ಯ ೋ ಗ ಿ ಸ ು ತ ್ ತ ಿ ರ ು ವ |
ಉಪಾಧ್ಯಕ್ಷ	ಉ ಪ ಾ ಧ ್ ಯ ಕ ್ ಷ |
ಉಪೇಂದ್ರ	ಉ ಪ ೇ ಂ ದ ್ ರ |
ಉಪ್ಪಾರ	ಉ ಪ ್ ಪ ಾ ರ |
ಉಭಯ	ಉ ಭ ಯ |
ಉರಿಯುತ್ತದೆ	ಉ ರ ಿ ಯ ು ತ ್ ತ ದ ೆ |
ಉರುಳು	ಉ ರ ು ಳ ು |
ಉಲಹಕ್	ಉ ಲ ಹ ಕ ್ |
ಉಲ್ಲೇಖ	ಉ ಲ ್ ಲ ೇ ಖ |
ಉಳಿ	ಉ ಳ ಿ |
ಉಳಿದ	ಉ ಳ ಿ ದ |
ಉಸ್ತುವಾರಿ	ಉ ಸ ್ ತ ು ವ ಾ ರ ಿ |
ಉಸ್ಮಾನಾಬಾದ್	ಉ ಸ ್ ಮ ಾ ನ ಾ ಬ ಾ ದ ್ |
ಊಟ	ಊ ಟ |
ಊಟಕ್ಕಿಂತ	ಊ ಟ ಕ ್ ಕ ಿ ಂ ತ |
ಊಟಕ್ಕಿದ್ದರೆ	ಊ ಟ ಕ ್ ಕ ಿ ದ ್ ದ ರ ೆ |
ಊಟಿ	ಊ ಟ ಿ |
ಊದು	ಊ ದ ು |
ಊನ	ಊ ನ |
ಊರಿಗೆ	ಊ ರ ಿ ಗ ೆ |
ಊರಿನ	ಊ ರ ಿ ನ |
ಊರಿನಲ್ಲಿ	ಊ ರ ಿ ನ ಲ ್ ಲ ಿ |
ಊರು	ಊ ರ ು |
ಊಹೆ	ಊ ಹ ೆ |
ಊಹೆಯ	ಊ ಹ ೆ ಯ |
ಋತು	ಋ ತ ು |
ಋಷಿಕೇಶ	ಋ ಷ ಿ ಕ ೇ ಶ |
ಎಂ	ಎ ಂ |
ಎಂಎಸ್	ಎ ಂ ಎ ಸ ್ |
ಎಂಟನೂರು	ಎ ಂ ಟ ನ ೂ ರ ು |
ಎಂಟನೆಯ	ಎ ಂ ಟ ನ ೆ ಯ |
ಎಂಟು	ಎ ಂ ಟ ು |
ಎಂದ	ಎ ಂ ದ |
ಎಂದರೆ	ಎ ಂ ದ ರ ೆ |
ಎಂದಿಗೂ	ಎ ಂ ದ ಿ ಗ ೂ |
ಎಂದು	ಎ ಂ ದ ು |
ಎಂಪಿ	ಎ ಂ ಪ ಿ |
ಎಂಬ	ಎ ಂ ಬ |
ಎಂಬತ್ತನಾಲ್ಕು	ಎ ಂ ಬ ತ ್ ತ ನ ಾ ಲ ್ ಕ ು |
ಎಂಬತ್ತಮೂರು	ಎ ಂ ಬ ತ ್ ತ ಮ ೂ ರ ು |
ಎಂಬತ್ತಾರು	ಎ ಂ ಬ ತ ್ ತ ಾ ರ ು |
ಎಂಬತ್ತು	ಎ ಂ ಬ ತ ್ ತ ು |
ಎಂಬತ್ತೆಂಟು	ಎ ಂ ಬ ತ ್ ತ ೆ ಂ ಟ ು |
ಎಂಬತ್ತೆರಡು	ಎ ಂ ಬ ತ ್ ತ ೆ ರ ಡ ು |
ಎಂಬತ್ತೇಳು	ಎ ಂ ಬ ತ ್ ತ ೇ ಳ ು |
ಎಂಬತ್ತೈದು	ಎ ಂ ಬ ತ ್ ತ ೈ ದ ು |
ಎಂಬತ್ತೊಂದು	ಎ ಂ ಬ ತ ್ ತ ೊ ಂ ದ ು |
ಎಂಬತ್ತೊಂಬತ್ತು	ಎ ಂ ಬ ತ ್ ತ ೊ ಂ ಬ ತ ್ ತ ು |
ಎಂಬುದು	ಎ ಂ ಬ ು ದ ು |
ಎಆರ್	ಎ ಆ ರ ್ |
ಎಎಲ್	ಎ ಎ ಲ ್ |
ಎಚ್ಚರ	ಎ ಚ ್ ಚ ರ |
ಎಚ್ಚರಿಕೆ	ಎ ಚ ್ ಚ ರ ಿ ಕ ೆ |
ಎಡ	ಎ ಡ |
ಎಡಗಡೆ	ಎ ಡ ಗ ಡ ೆ |
ಎತ್ತರ	ಎ ತ ್ ತ ರ |
ಎತ್ತಿನ	ಎ ತ ್ ತ ಿ ನ |
ಎತ್ತು	ಎ ತ ್ ತ ು |
ಎತ್ತುಗಳು	ಎ ತ ್ ತ ು ಗ ಳ ು |
ಎದುರಾಳಿ	ಎ ದ ು ರ ಾ ಳ ಿ |
ಎದುರಿಸು	ಎ ದ ು ರ ಿ ಸ ು |
ಎದುರು	ಎ ದ ು ರ ು |
ಎದೆ	ಎ ದ ೆ |
ಎದ್ದೇಳಿ	ಎ ದ ್ ದ ೇ ಳ ಿ |
ಎದ್ದೇಳಿಸು	ಎ ದ ್ ದ ೇ ಳ ಿ ಸ ು |
ಎದ್ದೇಳು	ಎ ದ ್ ದ ೇ ಳ ು |
ಎನಿಸು	ಎ ನ ಿ ಸ ು |
ಎನ್	ಎ ನ ್ |
ಎನ್ನು	ಎ ನ ್ ನ ು |
ಎಪಿಜೆ	ಎ ಪ ಿ ಜ ೆ |
ಎಪ್ಪತ್ತನಾಲ್ಕು	ಎ ಪ ್ ಪ ತ ್ ತ ನ ಾ ಲ ್ ಕ ು |
ಎಪ್ಪತ್ತಮೂರು	ಎ ಪ ್ ಪ ತ ್ ತ ಮ ೂ ರ ು |
ಎಪ್ಪತ್ತಾರು	ಎ ಪ ್ ಪ ತ ್ ತ ಾ ರ ು |
ಎಪ್ಪತ್ತು	ಎ ಪ ್ ಪ ತ ್ ತ ು |
ಎಪ್ಪತ್ತೆಂಟು	ಎ ಪ ್ ಪ ತ ್ ತ ೆ ಂ ಟ ು |
ಎಪ್ಪತ್ತೆರಡು	ಎ ಪ ್ ಪ ತ ್ ತ ೆ ರ ಡ ು |
ಎಪ್ಪತ್ತೇಳು	ಎ ಪ ್ ಪ ತ ್ ತ ೇ ಳ ು |
ಎಪ್ಪತ್ತೈದು	ಎ ಪ ್ ಪ ತ ್ ತ ೈ ದ ು |
ಎಪ್ಪತ್ತೊಂದು	ಎ ಪ ್ ಪ ತ ್ ತ ೊ ಂ ದ ು |
ಎಪ್ಪತ್ತೊಂಬತ್ತು	ಎ ಪ ್ ಪ ತ ್ ತ ೊ ಂ ಬ ತ ್ ತ ು |
ಎಫ್	ಎ ಫ ್ |
ಎಮ್ಮೆ	ಎ ಮ ್ ಮ ೆ |
ಎರಡನೆಯ	ಎ ರ ಡ ನ ೆ ಯ |
ಎರಡು	ಎ ರ ಡ ು |
ಎರ್ನಾಕುಲಮ್	ಎ ರ ್ ನ ಾ ಕ ು ಲ ಮ ್ |
ಎಲನಾ	ಎ ಲ ನ ಾ |
ಎಲಿಜೆಬೆತ್	ಎ ಲ ಿ ಜ ೆ ಬ ೆ ತ ್ |
ಎಲುಬು	ಎ ಲ ು ಬ ು |
ಎಲೆ	ಎ ಲ ೆ |
ಎಲ್	ಎ ಲ ್ |
ಎಲ್ಎ	ಎ ಲ ್ ಎ |
ಎಲ್ಲ	ಎ ಲ ್ ಲ |
ಎಲ್ಲರ	ಎ ಲ ್ ಲ ರ |
ಎಲ್ಲರೂ	ಎ ಲ ್ ಲ ರ ೂ |
ಎಲ್ಲಾ	ಎ ಲ ್ ಲ ಾ |
ಎಲ್ಲಾಪುರ	ಎ ಲ ್ ಲ ಾ ಪ ು ರ |
ಎಲ್ಲಿ	ಎ ಲ ್ ಲ ಿ |
ಎಲ್ಲಿಗೆ	ಎ ಲ ್ ಲ ಿ ಗ ೆ |
ಎಳಂದೂರು	ಎ ಳ ಂ ದ ೂ ರ ು |
ಎಳೆ	ಎ ಳ ೆ |
ಎಳೆಯುತ್ತಾರೆ	ಎ ಳ ೆ ಯ ು ತ ್ ತ ಾ ರ ೆ |
ಎಷ್ಟು	ಎ ಷ ್ ಟ ು |
ಎಷ್ಟೇ	ಎ ಷ ್ ಟ ೇ |
ಎಷ್ಟೋದಿನಗಳಾದವು	ಎ ಷ ್ ಟ ೋ ದ ಿ ನ ಗ ಳ ಾ ದ ವ ು |
ಎಸೆತ	ಎ ಸ ೆ ತ |
ಎಸ್	ಎ ಸ ್ |
ಎಸ್ಮಂಜುನಾಥ್	ಎ ಸ ್ ಮ ಂ ಜ ು ನ ಾ ಥ ್ |
ಏಂಡೀ	ಏ ಂ ಡ ೀ |
ಏಂಡ್ರಾ	ಏ ಂ ಡ ್ ರ ಾ |
ಏಕದಿನ	ಏ ಕ ದ ಿ ನ |
ಏಕರೆ	ಏ ಕ ರ ೆ |
ಏಕೆ	ಏ ಕ ೆ |
ಏಕೆಂದರೆ	ಏ ಕ ೆ ಂ ದ ರ ೆ |
ಏಕೈಕ	ಏ ಕ ೈ ಕ |
ಏಡಮ್	ಏ ಡ ಮ ್ |
ಏಡಿ	ಏ ಡ ಿ |
ಏಣಿ	ಏ ಣ ಿ |
ಏಣಿಗಳನ್ನು	ಏ ಣ ಿ ಗ ಳ ನ ್ ನ ು |
ಏನು	ಏ ನ ು |
ಏನೂ	ಏ ನ ೂ |
ಏನೇ	ಏ ನ ೇ |
ಏಪ್ರಿಲ್	ಏ ಪ ್ ರ ಿ ಲ ್ |
ಏರು	ಏ ರ ು |
ಏರುತ್ತೇನೆ	ಏ ರ ು ತ ್ ತ ೇ ನ ೆ |
ಏಳನೆಯ	ಏ ಳ ನ ೆ ಯ |
ಏಳಿಗೆ	ಏ ಳ ಿ ಗ ೆ |
ಏಳು	ಏ ಳ ು |
ಏಳುನೂರು	ಏ ಳ ು ನ ೂ ರ ು |
ಏಸುದಾಸ್	ಏ ಸ ು ದ ಾ ಸ ್ |
ಐತಿಹಾಸಿಕ	ಐ ತ ಿ ಹ ಾ ಸ ಿ ಕ |
ಐದನೆಯ	ಐ ದ ನ ೆ ಯ |
ಐದು	ಐ ದ ು |
ಐನೂರು	ಐ ನ ೂ ರ ು |
ಐವತ್ತಮೂರು	ಐ ವ ತ ್ ತ ಮ ೂ ರ ು |
ಐವತ್ತಾರು	ಐ ವ ತ ್ ತ ಾ ರ ು |
ಐವತ್ತು	ಐ ವ ತ ್ ತ ು |
ಐವತ್ತೆಂಟು	ಐ ವ ತ ್ ತ ೆ ಂ ಟ ು |
ಐವತ್ತೆರಡು	ಐ ವ ತ ್ ತ ೆ ರ ಡ ು |
ಐವತ್ತೇಳು	ಐ ವ ತ ್ ತ ೇ ಳ ು |
ಐವತ್ತೈದು	ಐ ವ ತ ್ ತ ೈ ದ ು |
ಐವತ್ತೊಂದು	ಐ ವ ತ ್ ತ ೊ ಂ ದ ು |
ಐವತ್ತೊಂಬತ್ತು	ಐ ವ ತ ್ ತ ೊ ಂ ಬ ತ ್ ತ ು |
ಐವತ್ನಾಲ್ಕು	ಐ ವ ತ ್ ನ ಾ ಲ ್ ಕ ು |
ಐಶ್ವರ್ಯ	ಐ ಶ ್ ವ ರ ್ ಯ |
ಐಶ್ವರ್ಯರೈ	ಐ ಶ ್ ವ ರ ್ ಯ ರ ೈ |
ಒಂದು	ಒ ಂ ದ ು |
ಒಂದೆಡೆ	ಒ ಂ ದ ೆ ಡ ೆ |
ಒಂದೇ	ಒ ಂ ದ ೇ |
ಒಂಬತ್ತನೆಯ	ಒ ಂ ಬ ತ ್ ತ ನ ೆ ಯ |
ಒಂಬತ್ತು	ಒ ಂ ಬ ತ ್ ತ ು |
ಒಂಬೈನೂರು	ಒ ಂ ಬ ೈ ನ ೂ ರ ು |
ಒಗೆ	ಒ ಗ ೆ |
ಒಗೆದು	ಒ ಗ ೆ ದ ು |
ಒಟ್ಟಾರೆ	ಒ ಟ ್ ಟ ಾ ರ ೆ |
ಒಟ್ಟಿಗೆ	ಒ ಟ ್ ಟ ಿ ಗ ೆ |
ಒಟ್ಟು	ಒ ಟ ್ ಟ ು |
ಒಡೆ	ಒ ಡ ೆ |
ಒಡೆದು	ಒ ಡ ೆ ದ ು |
ಒಡೆಯಬೇಡ	ಒ ಡ ೆ ಯ ಬ ೇ ಡ |
ಒಡೆಯರ್	ಒ ಡ ೆ ಯ ರ ್ |
ಒಡೆಯಿರಿ	ಒ ಡ ೆ ಯ ಿ ರ ಿ |
ಒಣ	ಒ ಣ |
ಒತ್ತಡ	ಒ ತ ್ ತ ಡ |
ಒತ್ತಾಯ	ಒ ತ ್ ತ ಾ ಯ |
ಒತ್ತು	ಒ ತ ್ ತ ು |
ಒದಗು	ಒ ದ ಗ ು |
ಒನಕೆ	ಒ ನ ಕ ೆ |
ಒಪ್ಪಂದ	ಒ ಪ ್ ಪ ಂ ದ |
ಒಪ್ಪಿಗೆ	ಒ ಪ ್ ಪ ಿ ಗ ೆ |
ಒಪ್ಪು	ಒ ಪ ್ ಪ ು |
ಒಬ್ಬ	ಒ ಬ ್ ಬ |
ಒಮ್ಮೆ	ಒ ಮ ್ ಮ ೆ |
ಒಲವು	ಒ ಲ ವ ು |
ಒಳ	ಒ ಳ |
ಒಳಗೆ	ಒ ಳ ಗ ೆ |
ಒಳಗೊಂಡ	ಒ ಳ ಗ ೊ ಂ ಡ |
ಒಳ್ಳೆ	ಒ ಳ ್ ಳ ೆ |
ಒಳ್ಳೆಯ	ಒ ಳ ್ ಳ ೆ ಯ |
ಒಳ್ಳೆಯದಲ್ಲ	ಒ ಳ ್ ಳ ೆ ಯ ದ ಲ ್ ಲ |
ಒಳ್ಳೆಯದಾಗಿರಬೇಕು	ಒ ಳ ್ ಳ ೆ ಯ ದ ಾ ಗ ಿ ರ ಬ ೇ ಕ ು |
ಒಳ್ಳೆಯದು	ಒ ಳ ್ ಳ ೆ ಯ ದ ು |
ಓಂ	ಓ ಂ |
ಓಕುಳಿ	ಓ ಕ ು ಳ ಿ |
ಓಟ	ಓ ಟ |
ಓಟದ	ಓ ಟ ದ |
ಓಡಾಡುತ್ತಾರೆ	ಓ ಡ ಾ ಡ ು ತ ್ ತ ಾ ರ ೆ |
ಓಡಿಸಬೇಡ	ಓ ಡ ಿ ಸ ಬ ೇ ಡ |
ಓಡಿಸಿ	ಓ ಡ ಿ ಸ ಿ |
ಓಡಿಸು	ಓ ಡ ಿ ಸ ು |
ಓಡು	ಓ ಡ ು |
ಓದಬೇಡ	ಓ ದ ಬ ೇ ಡ |
ಓದಿ	ಓ ದ ಿ |
ಓದು	ಓ ದ ು |
ಓದುಗ	ಓ ದ ು ಗ |
ಓಬವ್ವ	ಓ ಬ ವ ್ ವ |
ಓರಗಿತ್ತಿ	ಓ ರ ಗ ಿ ತ ್ ತ ಿ |
ಓರಣ	ಓ ರ ಣ |
ಓಹೋ	ಓ ಹ ೋ |
ಔರಂಗಾಬಾದ್	ಔ ರ ಂ ಗ ಾ ಬ ಾ ದ ್ |
ಕ	ಕ |
ಕಂಕುಳ	ಕ ಂ ಕ ು ಳ |
ಕಂಗನಾ	ಕ ಂ ಗ ನ ಾ |
ಕಂಚಿ	ಕ ಂ ಚ ಿ |
ಕಂಚಿನ	ಕ ಂ ಚ ಿ ನ |
ಕಂಡ	ಕ ಂ ಡ |
ಕಂಡರೆ	ಕ ಂ ಡ ರ ೆ |
ಕಂಡು	ಕ ಂ ಡ ು |
ಕಂಡುಬರು	ಕ ಂ ಡ ು ಬ ರ ು |
ಕಂದು	ಕ ಂ ದ ು |
ಕಂಪನಿ	ಕ ಂ ಪ ನ ಿ |
ಕಂಪಲಿ	ಕ ಂ ಪ ಲ ಿ |
ಕಂಪಿಲ್	ಕ ಂ ಪ ಿ ಲ ್ |
ಕಂಬ್ಲಿ	ಕ ಂ ಬ ್ ಲ ಿ |
ಕಚೇರಿ	ಕ ಚ ೇ ರ ಿ |
ಕಜ್ಜಿ	ಕ ಜ ್ ಜ ಿ |
ಕಟಕ್	ಕ ಟ ಕ ್ |
ಕಟಿಹಾರ	ಕ ಟ ಿ ಹ ಾ ರ |
ಕಟ್ಟಡ	ಕ ಟ ್ ಟ ಡ |
ಕಟ್ಟು	ಕ ಟ ್ ಟ ು |
ಕಟ್ಟುತ್ತವೆ	ಕ ಟ ್ ಟ ು ತ ್ ತ ವ ೆ |
ಕಟ್ಟುನಿಟ್ಟಾಗಿ	ಕ ಟ ್ ಟ ು ನ ಿ ಟ ್ ಟ ಾ ಗ ಿ |
ಕಟ್ಟೆ	ಕ ಟ ್ ಟ ೆ |
ಕಟ್ರ	ಕ ಟ ್ ರ |
ಕಠಿಣ	ಕ ಠ ಿ ಣ |
ಕಡಕೊಳ	ಕ ಡ ಕ ೊ ಳ |
ಕಡಿಮೆ	ಕ ಡ ಿ ಮ ೆ |
ಕಡೂರು	ಕ ಡ ೂ ರ ು |
ಕಡೆ	ಕ ಡ ೆ |
ಕಡ್ಡಿ	ಕ ಡ ್ ಡ ಿ |
ಕಣ	ಕ ಣ |
ಕಣಗಾಲ್	ಕ ಣ ಗ ಾ ಲ ್ |
ಕಣ್ಣಿನ	ಕ ಣ ್ ಣ ಿ ನ |
ಕಣ್ಣು	ಕ ಣ ್ ಣ ು |
ಕತೆ	ಕ ತ ೆ |
ಕತ್ತಿ	ಕ ತ ್ ತ ಿ |
ಕತ್ತಿಯಂತೆ	ಕ ತ ್ ತ ಿ ಯ ಂ ತ ೆ |
ಕತ್ತು	ಕ ತ ್ ತ ು |
ಕಥೆ	ಕ ಥ ೆ |
ಕನಕದಾಸ	ಕ ನ ಕ ದ ಾ ಸ |
ಕನಕಪುರ	ಕ ನ ಕ ಪ ು ರ |
ಕನಸು	ಕ ನ ಸ ು |
ಕನಿಷ್ಠ	ಕ ನ ಿ ಷ ್ ಠ |
ಕನ್ನಡ	ಕ ನ ್ ನ ಡ |
ಕನ್ನಡಿಗ	ಕ ನ ್ ನ ಡ ಿ ಗ |
ಕನ್ನೌಜ್	ಕ ನ ್ ನ ೌ ಜ ್ |
ಕನ್ಯಾ	ಕ ನ ್ ಯ ಾ |
ಕನ್ಯಾಕುಮಾರಿ	ಕ ನ ್ ಯ ಾ ಕ ು ಮ ಾ ರ ಿ |
ಕಪಿಲ್	ಕ ಪ ಿ ಲ ್ |
ಕಪೂರ್	ಕ ಪ ೂ ರ ್ |
ಕಪ್ಪು	ಕ ಪ ್ ಪ ು |
ಕಪ್ಪೆ	ಕ ಪ ್ ಪ ೆ |
ಕಪ್ಪೆಗಳು	ಕ ಪ ್ ಪ ೆ ಗ ಳ ು |
ಕಬೀರ	ಕ ಬ ೀ ರ |
ಕಬ್ಬಿಣದ	ಕ ಬ ್ ಬ ಿ ಣ ದ |
ಕಬ್ಬು	ಕ ಬ ್ ಬ ು |
ಕಮಲ್	ಕ ಮ ಲ ್ |
ಕಮ್ಮಿ	ಕ ಮ ್ ಮ ಿ |
ಕರ	ಕ ರ |
ಕರನ್	ಕ ರ ನ ್ |
ಕರಳು	ಕ ರ ಳ ು |
ಕರಿಷ್ಮಾ	ಕ ರ ಿ ಷ ್ ಮ ಾ |
ಕರೆ	ಕ ರ ೆ |
ಕರೆಯಬೇಡ	ಕ ರ ೆ ಯ ಬ ೇ ಡ |
ಕರೆಯಿರಿ	ಕ ರ ೆ ಯ ಿ ರ ಿ |
ಕರ್ಕಾಟಕ	ಕ ರ ್ ಕ ಾ ಟ ಕ |
ಕರ್ತವ್ಯ	ಕ ರ ್ ತ ವ ್ ಯ |
ಕರ್ಮ	ಕ ರ ್ ಮ |
ಕರ್ರಗೆ	ಕ ರ ್ ರ ಗ ೆ |
ಕಲಘಟಗಿ	ಕ ಲ ಘ ಟ ಗ ಿ |
ಕಲಾಮ್	ಕ ಲ ಾ ಮ ್ |
ಕಲಾವಿದ	ಕ ಲ ಾ ವ ಿ ದ |
ಕಲಿ	ಕ ಲ ಿ |
ಕಲಿಸು	ಕ ಲ ಿ ಸ ು |
ಕಲೀನ್	ಕ ಲ ೀ ನ ್ |
ಕಲೆ	ಕ ಲ ೆ |
ಕಲ್ಪನೆ	ಕ ಲ ್ ಪ ನ ೆ |
ಕಲ್ಪಿಸು	ಕ ಲ ್ ಪ ಿ ಸ ು |
ಕಲ್ಯಾಣ	ಕ ಲ ್ ಯ ಾ ಣ |
ಕಲ್ಲಹಳ್ಳಿ	ಕ ಲ ್ ಲ ಹ ಳ ್ ಳ ಿ |
ಕಲ್ಲು	ಕ ಲ ್ ಲ ು |
ಕಳಿಸಬೇಡ	ಕ ಳ ಿ ಸ ಬ ೇ ಡ |
ಕಳಿಸಿರಿ	ಕ ಳ ಿ ಸ ಿ ರ ಿ |
ಕಳಿಸು	ಕ ಳ ಿ ಸ ು |
ಕಳೆ	ಕ ಳ ೆ |
ಕಳೆದ	ಕ ಳ ೆ ದ |
ಕಳೆದಂತೆ	ಕ ಳ ೆ ದ ಂ ತ ೆ |
ಕಳೆದು	ಕ ಳ ೆ ದ ು |
ಕಳ್ಳ	ಕ ಳ ್ ಳ |
ಕವನ	ಕ ವ ನ |
ಕವರತಿ	ಕ ವ ರ ತ ಿ |
ಕವಿ	ಕ ವ ಿ |
ಕವಿತೆ	ಕ ವ ಿ ತ ೆ |
ಕಶೇರು	ಕ ಶ ೇ ರ ು |
ಕಷಾಯ	ಕ ಷ ಾ ಯ |
ಕಷ್ಟ	ಕ ಷ ್ ಟ |
ಕಸಲಗೆರೆ	ಕ ಸ ಲ ಗ ೆ ರ ೆ |
ಕಾಂಗ್ರೆಸ್	ಕ ಾ ಂ ಗ ್ ರ ೆ ಸ ್ |
ಕಾಂತ್	ಕ ಾ ಂ ತ ್ |
ಕಾಕನಕೋಟೆ	ಕ ಾ ಕ ನ ಕ ೋ ಟ ೆ |
ಕಾಗದ	ಕ ಾ ಗ ದ |
ಕಾಗೆ	ಕ ಾ ಗ ೆ |
ಕಾಡು	ಕ ಾ ಡ ು |
ಕಾಣಿಸು	ಕ ಾ ಣ ಿ ಸ ು |
ಕಾಣಿಸುತ್ತದೆ	ಕ ಾ ಣ ಿ ಸ ು ತ ್ ತ ದ ೆ |
ಕಾಣು	ಕ ಾ ಣ ು |
ಕಾಣುಸುತ್ತದೆ	ಕ ಾ ಣ ು ಸ ು ತ ್ ತ ದ ೆ |
ಕಾದಂಬರಿ	ಕ ಾ ದ ಂ ಬ ರ ಿ |
ಕಾದು	ಕ ಾ ದ ು |
ಕಾನೂನು	ಕ ಾ ನ ೂ ನ ು |
ಕಾನ್	ಕ ಾ ನ ್ |
ಕಾಫಿ	ಕ ಾ ಫ ಿ |
ಕಾಮನಬಿಲ್ಲಿನಂತೆ	ಕ ಾ ಮ ನ ಬ ಿ ಲ ್ ಲ ಿ ನ ಂ ತ ೆ |
ಕಾಯಮ್	ಕ ಾ ಯ ಮ ್ |
ಕಾಯಿ	ಕ ಾ ಯ ಿ |
ಕಾಯಿದೆ	ಕ ಾ ಯ ಿ ದ ೆ |
ಕಾಯ್ಕಿಣಿ	ಕ ಾ ಯ ್ ಕ ಿ ಣ ಿ |
ಕಾರಂತ್	ಕ ಾ ರ ಂ ತ ್ |
ಕಾರಣ	ಕ ಾ ರ ಣ |
ಕಾರವಾರ	ಕ ಾ ರ ವ ಾ ರ |
ಕಾರು	ಕ ಾ ರ ು |
ಕಾರ್ಕಳ	ಕ ಾ ರ ್ ಕ ಳ |
ಕಾರ್ತೀಕ	ಕ ಾ ರ ್ ತ ೀ ಕ |
ಕಾರ್ನಾಡ್	ಕ ಾ ರ ್ ನ ಾ ಡ ್ |
ಕಾರ್ಮಿಕ	ಕ ಾ ರ ್ ಮ ಿ ಕ |
ಕಾರ್ಯ	ಕ ಾ ರ ್ ಯ |
ಕಾರ್ಯಕರ್ತ	ಕ ಾ ರ ್ ಯ ಕ ರ ್ ತ |
ಕಾರ್ಯಕ್ರಮ	ಕ ಾ ರ ್ ಯ ಕ ್ ರ ಮ |
ಕಾರ್ಯದರ್ಶಿ	ಕ ಾ ರ ್ ಯ ದ ರ ್ ಶ ಿ |
ಕಾರ್ಲ	ಕ ಾ ರ ್ ಲ |
ಕಾಲ	ಕ ಾ ಲ |
ಕಾಲದ	ಕ ಾ ಲ ದ |
ಕಾಲದಲ್ಲಿ	ಕ ಾ ಲ ದ ಲ ್ ಲ ಿ |
ಕಾಲದಿಂದಲೂ	ಕ ಾ ಲ ದ ಿ ಂ ದ ಲ ೂ |
ಕಾಲಾಹಾಂಡಿ	ಕ ಾ ಲ ಾ ಹ ಾ ಂ ಡ ಿ |
ಕಾಲಿ	ಕ ಾ ಲ ಿ |
ಕಾಲಿಕಟ್	ಕ ಾ ಲ ಿ ಕ ಟ ್ |
ಕಾಲು	ಕ ಾ ಲ ು |
ಕಾಲುವೆ	ಕ ಾ ಲ ು ವ ೆ |
ಕಾಲೂ	ಕ ಾ ಲ ೂ |
ಕಾಲೇಜಿನವರೇ	ಕ ಾ ಲ ೇ ಜ ಿ ನ ವ ರ ೇ |
ಕಾಲೇಜಿನಿಂದ	ಕ ಾ ಲ ೇ ಜ ಿ ನ ಿ ಂ ದ |
ಕಾಲೇಜು	ಕ ಾ ಲ ೇ ಜ ು |
ಕಾಳು	ಕ ಾ ಳ ು |
ಕಾಳುಗಳನ್ನು	ಕ ಾ ಳ ು ಗ ಳ ನ ್ ನ ು |
ಕಾಳೇನಹಳ್ಳಿ	ಕ ಾ ಳ ೇ ನ ಹ ಳ ್ ಳ ಿ |
ಕಾವೇರಿ	ಕ ಾ ವ ೇ ರ ಿ |
ಕಾವ್ಯ	ಕ ಾ ವ ್ ಯ |
ಕಾಶಿನಾಥ್	ಕ ಾ ಶ ಿ ನ ಾ ಥ ್ |
ಕಾಸರವಳ್ಳಿ	ಕ ಾ ಸ ರ ವ ಳ ್ ಳ ಿ |
ಕಿಂಗ್	ಕ ಿ ಂ ಗ ್ |
ಕಿತ್ತಳೆ	ಕ ಿ ತ ್ ತ ಳ ೆ |
ಕಿತ್ತು	ಕ ಿ ತ ್ ತ ು |
ಕಿತ್ತೂರು	ಕ ಿ ತ ್ ತ ೂ ರ ು |
ಕಿರಣ್	ಕ ಿ ರ ಣ ್ |
ಕಿರಿಯ	ಕ ಿ ರ ಿ ಯ |
ಕಿರ್ಮಾನಿ	ಕ ಿ ರ ್ ಮ ಾ ನ ಿ |
ಕಿವಿ	ಕ ಿ ವ ಿ |
ಕಿವಿಗೆ	ಕ ಿ ವ ಿ ಗ ೆ |
ಕಿಶೋರ	ಕ ಿ ಶ ೋ ರ |
ಕೀರ್ತಿ	ಕ ೀ ರ ್ ತ ಿ |
ಕೀಲು	ಕ ೀ ಲ ು |
ಕೀಳು	ಕ ೀ ಳ ು |
ಕುಂ	ಕ ು ಂ |
ಕುಂತೂರು	ಕ ು ಂ ತ ೂ ರ ು |
ಕುಂದಗಿ	ಕ ು ಂ ದ ಗ ಿ |
ಕುಂದಗೋಳ್	ಕ ು ಂ ದ ಗ ೋ ಳ ್ |
ಕುಂದರಗಿ	ಕ ು ಂ ದ ರ ಗ ಿ |
ಕುಂದಾಪುರ	ಕ ು ಂ ದ ಾ ಪ ು ರ |
ಕುಂಬ್ಳೆ	ಕ ು ಂ ಬ ್ ಳ ೆ |
ಕುಂಭ	ಕ ು ಂ ಭ |
ಕುಕ್ಕೆ	ಕ ು ಕ ್ ಕ ೆ |
ಕುಚೆರಾ	ಕ ು ಚ ೆ ರ ಾ |
ಕುಟುಂಬ	ಕ ು ಟ ು ಂ ಬ |
ಕುಡಿ	ಕ ು ಡ ಿ |
ಕುಡಿಯಬೇಡ	ಕ ು ಡ ಿ ಯ ಬ ೇ ಡ |
ಕುಡಿಯಿರಿ	ಕ ು ಡ ಿ ಯ ಿ ರ ಿ |
ಕುಡಿಯುವುದರಿಂದ	ಕ ು ಡ ಿ ಯ ು ವ ು ದ ರ ಿ ಂ ದ |
ಕುತೂಹಲ	ಕ ು ತ ೂ ಹ ಲ |
ಕುದುರೆ	ಕ ು ದ ು ರ ೆ |
ಕುಮಾರ	ಕ ು ಮ ಾ ರ |
ಕುಮಾರ್	ಕ ು ಮ ಾ ರ ್ |
ಕುಮ್ಟಾ	ಕ ು ಮ ್ ಟ ಾ |
ಕುರಿತ	ಕ ು ರ ಿ ತ |
ಕುರುಕ್ಷೇತ್ರ	ಕ ು ರ ು ಕ ್ ಷ ೇ ತ ್ ರ |
ಕುರುಡ	ಕ ು ರ ು ಡ |
ಕುರುಡನಂತೆ	ಕ ು ರ ು ಡ ನ ಂ ತ ೆ |
ಕುರ್ವಿಲ್ಲ	ಕ ು ರ ್ ವ ಿ ಲ ್ ಲ |
ಕುರ್ಸಿಯಾಗ್	ಕ ು ರ ್ ಸ ಿ ಯ ಾ ಗ ್ |
ಕುಲಕರ್ಣಿ	ಕ ು ಲ ಕ ರ ್ ಣ ಿ |
ಕುಲ್ಲು	ಕ ು ಲ ್ ಲ ು |
ಕುಳಿತ	ಕ ು ಳ ಿ ತ |
ಕುಳಿತು	ಕ ು ಳ ಿ ತ ು |
ಕುಳಿತುಕೊ	ಕ ು ಳ ಿ ತ ು ಕ ೊ |
ಕುಳಿತುಕೊಳ್ಳಿ	ಕ ು ಳ ಿ ತ ು ಕ ೊ ಳ ್ ಳ ಿ |
ಕುವೆಂಪು	ಕ ು ವ ೆ ಂ ಪ ು |
ಕುಷ್ಟಗಿ	ಕ ು ಷ ್ ಟ ಗ ಿ |
ಕೂಗು	ಕ ೂ ಗ ು |
ಕೂಚ್	ಕ ೂ ಚ ್ |
ಕೂಟ	ಕ ೂ ಟ |
ಕೂಡ	ಕ ೂ ಡ |
ಕೂಡಲೇ	ಕ ೂ ಡ ಲ ೇ |
ಕೂಡಿ	ಕ ೂ ಡ ಿ |
ಕೂದಲು	ಕ ೂ ದ ಲ ು |
ಕೂರು	ಕ ೂ ರ ು |
ಕೂರ್ಗ್	ಕ ೂ ರ ್ ಗ ್ |
ಕೃತಿ	ಕ ೃ ತ ಿ |
ಕೃಷಿ	ಕ ೃ ಷ ಿ |
ಕೃಷ್ಣ	ಕ ೃ ಷ ್ ಣ |
ಕೃಷ್ಣಂ	ಕ ೃ ಷ ್ ಣ ಂ |
ಕೃಷ್ಣದೇವರಾಯ	ಕ ೃ ಷ ್ ಣ ದ ೇ ವ ರ ಾ ಯ |
ಕೃಷ್ಣರಾಜ	ಕ ೃ ಷ ್ ಣ ರ ಾ ಜ |
ಕೃಷ್ಣರಾಜಪೇಟೆ	ಕ ೃ ಷ ್ ಣ ರ ಾ ಜ ಪ ೇ ಟ ೆ |
ಕೃಷ್ಣರಾಯ	ಕ ೃ ಷ ್ ಣ ರ ಾ ಯ |
ಕೃಷ್ಣರಾಯರು	ಕ ೃ ಷ ್ ಣ ರ ಾ ಯ ರ ು |
ಕೆ	ಕ ೆ |
ಕೆಂಗಲ್	ಕ ೆ ಂ ಗ ಲ ್ |
ಕೆಂಪು	ಕ ೆ ಂ ಪ ು |
ಕೆಂಪುನಾರಾಯಣ	ಕ ೆ ಂ ಪ ು ನ ಾ ರ ಾ ಯ ಣ |
ಕೆಂಪೇಗೌಡ	ಕ ೆ ಂ ಪ ೇ ಗ ೌ ಡ |
ಕೆಆರ್ಎಸ್	ಕ ೆ ಆ ರ ್ ಎ ಸ ್ |
ಕೆಎಸ್ನರಸಿಂಹಸ್ವಾಮಿ	ಕ ೆ ಎ ಸ ್ ನ ರ ಸ ಿ ಂ ಹ ಸ ್ ವ ಾ ಮ ಿ |
ಕೆಕರುಣಾನಿಧಿ	ಕ ೆ ಕ ರ ು ಣ ಾ ನ ಿ ಧ ಿ |
ಕೆಟ್ಟ	ಕ ೆ ಟ ್ ಟ |
ಕೆನ್ನೆ	ಕ ೆ ನ ್ ನ ೆ |
ಕೆಮ್ಮು	ಕ ೆ ಮ ್ ಮ ು |
ಕೆರಗೋಡು	ಕ ೆ ರ ಗ ೋ ಡ ು |
ಕೆರೆ	ಕ ೆ ರ ೆ |
ಕೆಲವರು	ಕ ೆ ಲ ವ ರ ು |
ಕೆಲಸ	ಕ ೆ ಲ ಸ |
ಕೆಲಸಕ್ಕೆ	ಕ ೆ ಲ ಸ ಕ ್ ಕ ೆ |
ಕೆಳಗಿನ	ಕ ೆ ಳ ಗ ಿ ನ |
ಕೆಳಗೆ	ಕ ೆ ಳ ಗ ೆ |
ಕೇಂದ್ರ	ಕ ೇ ಂ ದ ್ ರ |
ಕೇದಾರನಾಥ್	ಕ ೇ ದ ಾ ರ ನ ಾ ಥ ್ |
ಕೇರಿ	ಕ ೇ ರ ಿ |
ಕೇಳಬೇಡ	ಕ ೇ ಳ ಬ ೇ ಡ |
ಕೇಳಲು	ಕ ೇ ಳ ಲ ು |
ಕೇಳಿ	ಕ ೇ ಳ ಿ |
ಕೇಳಿಸಿಕೊ	ಕ ೇ ಳ ಿ ಸ ಿ ಕ ೊ |
ಕೇಳಿಸಿಕೊಳ್ಳಬೇಡ	ಕ ೇ ಳ ಿ ಸ ಿ ಕ ೊ ಳ ್ ಳ ಬ ೇ ಡ |
ಕೇಳಿಸಿಕೊಳ್ಳಿರಿ	ಕ ೇ ಳ ಿ ಸ ಿ ಕ ೊ ಳ ್ ಳ ಿ ರ ಿ |
ಕೇಳು	ಕ ೇ ಳ ು |
ಕೇವಲ	ಕ ೇ ವ ಲ |
ಕೇಶಿರಾಜ	ಕ ೇ ಶ ಿ ರ ಾ ಜ |
ಕೇಸರಿ	ಕ ೇ ಸ ರ ಿ |
ಕೈ	ಕ ೈ |
ಕೈಗಾರಿಕೆ	ಕ ೈ ಗ ಾ ರ ಿ ಕ ೆ |
ಕೈಗೊಂಡ	ಕ ೈ ಗ ೊ ಂ ಡ |
ಕೈಗೊಳ್ಳು	ಕ ೈ ಗ ೊ ಳ ್ ಳ ು |
ಕೈಲಿಸ್	ಕ ೈ ಲ ಿ ಸ ್ |
ಕೊಂಕಣ	ಕ ೊ ಂ ಕ ಣ |
ಕೊಂಚ	ಕ ೊ ಂ ಚ |
ಕೊಂಡ	ಕ ೊ ಂ ಡ |
ಕೊಂಡು	ಕ ೊ ಂ ಡ ು |
ಕೊಂಡೇಕರ್	ಕ ೊ ಂ ಡ ೇ ಕ ರ ್ |
ಕೊಚ್ಚಿ	ಕ ೊ ಚ ್ ಚ ಿ |
ಕೊಚ್ಚಿಕೊಳ್ಳುತ್ತಾರೆ	ಕ ೊ ಚ ್ ಚ ಿ ಕ ೊ ಳ ್ ಳ ು ತ ್ ತ ಾ ರ ೆ |
ಕೊಚ್ಚಿನ್	ಕ ೊ ಚ ್ ಚ ಿ ನ ್ |
ಕೊಟ್ಟ	ಕ ೊ ಟ ್ ಟ |
ಕೊಟ್ಟಾಯಮ್	ಕ ೊ ಟ ್ ಟ ಾ ಯ ಮ ್ |
ಕೊಟ್ಟಿದ್ದಾರೆ	ಕ ೊ ಟ ್ ಟ ಿ ದ ್ ದ ಾ ರ ೆ |
ಕೊಟ್ಟಿರುವ	ಕ ೊ ಟ ್ ಟ ಿ ರ ು ವ |
ಕೊಡ	ಕ ೊ ಡ |
ಕೊಡಗು	ಕ ೊ ಡ ಗ ು |
ಕೊಡದಿದ್ದರೆ	ಕ ೊ ಡ ದ ಿ ದ ್ ದ ರ ೆ |
ಕೊಡಬೇಡ	ಕ ೊ ಡ ಬ ೇ ಡ |
ಕೊಡಿ	ಕ ೊ ಡ ಿ |
ಕೊಡು	ಕ ೊ ಡ ು |
ಕೊಡುಗೆ	ಕ ೊ ಡ ು ಗ ೆ |
ಕೊಡ್ಲಿಪೇಟೆ	ಕ ೊ ಡ ್ ಲ ಿ ಪ ೇ ಟ ೆ |
ಕೊನೆ	ಕ ೊ ನ ೆ |
ಕೊಪ್ಪ	ಕ ೊ ಪ ್ ಪ |
ಕೊಪ್ಪಳ	ಕ ೊ ಪ ್ ಪ ಳ |
ಕೊಬ್ಬು	ಕ ೊ ಬ ್ ಬ ು |
ಕೊಯಂಬತ್ತೂರ್	ಕ ೊ ಯ ಂ ಬ ತ ್ ತ ೂ ರ ್ |
ಕೊಯಿರಾಲ	ಕ ೊ ಯ ಿ ರ ಾ ಲ |
ಕೊಯಿರಾಲಾ	ಕ ೊ ಯ ಿ ರ ಾ ಲ ಾ |
ಕೊರಟಗೆರೆ	ಕ ೊ ರ ಟ ಗ ೆ ರ ೆ |
ಕೊರತೆ	ಕ ೊ ರ ತ ೆ |
ಕೊರಬಾ	ಕ ೊ ರ ಬ ಾ |
ಕೊರಳು	ಕ ೊ ರ ಳ ು |
ಕೊಲೆ	ಕ ೊ ಲ ೆ |
ಕೊಲ್ಕತಾಕೊಲ್ಕತ್ತಾ	ಕ ೊ ಲ ್ ಕ ತ ಾ ಕ ೊ ಲ ್ ಕ ತ ್ ತ ಾ |
ಕೊಲ್ಲು	ಕ ೊ ಲ ್ ಲ ು |
ಕೊಲ್ವೇಲ್	ಕ ೊ ಲ ್ ವ ೇ ಲ ್ |
ಕೊಲ್ಹಾಪುರ್	ಕ ೊ ಲ ್ ಹ ಾ ಪ ು ರ ್ |
ಕೊಳೆ	ಕ ೊ ಳ ೆ |
ಕೊಳ್ಳು	ಕ ೊ ಳ ್ ಳ ು |
ಕೊಳ್ಳೆಗಾಲ	ಕ ೊ ಳ ್ ಳ ೆ ಗ ಾ ಲ |
ಕೊಹಿಮಾ	ಕ ೊ ಹ ಿ ಮ ಾ |
ಕೋಚರಿಲ್	ಕ ೋ ಚ ರ ಿ ಲ ್ |
ಕೋಟಾ	ಕ ೋ ಟ ಾ |
ಕೋಟಿ	ಕ ೋ ಟ ಿ |
ಕೋಟೆ	ಕ ೋ ಟ ೆ |
ಕೋಟ್	ಕ ೋ ಟ ್ |
ಕೋಣೆ	ಕ ೋ ಣ ೆ |
ಕೋಣೆಯಲ್ಲಿ	ಕ ೋ ಣ ೆ ಯ ಲ ್ ಲ ಿ |
ಕೋತಿ	ಕ ೋ ತ ಿ |
ಕೋತಿಯ	ಕ ೋ ತ ಿ ಯ |
ಕೋದರಾಮ	ಕ ೋ ದ ರ ಾ ಮ |
ಕೋಪ	ಕ ೋ ಪ |
ಕೋಯಿರಾಲಾ	ಕ ೋ ಯ ಿ ರ ಾ ಲ ಾ |
ಕೋಯಿಲ್	ಕ ೋ ಯ ಿ ಲ ್ |
ಕೋರ್ಟು	ಕ ೋ ರ ್ ಟ ು |
ಕೋಳ್ಳೆಗಾಲ	ಕ ೋ ಳ ್ ಳ ೆ ಗ ಾ ಲ |
ಕೌಶಿಕ್	ಕ ೌ ಶ ಿ ಕ ್ |
ಕ್ಯಾಪ್ರಿಯೋ	ಕ ್ ಯ ಾ ಪ ್ ರ ಿ ಯ ೋ |
ಕ್ಯಾಮರ	ಕ ್ ಯ ಾ ಮ ರ |
ಕ್ಯಾಮರಾಗಳನ್ನು	ಕ ್ ಯ ಾ ಮ ರ ಾ ಗ ಳ ನ ್ ನ ು |
ಕ್ರಮ	ಕ ್ ರ ಮ |
ಕ್ರಮಾಂಕ	ಕ ್ ರ ಮ ಾ ಂ ಕ |
ಕ್ರಮೇಣ	ಕ ್ ರ ಮ ೇ ಣ |
ಕ್ರಾಂತಿ	ಕ ್ ರ ಾ ಂ ತ ಿ |
ಕ್ರಿಯೆ	ಕ ್ ರ ಿ ಯ ೆ |
ಕ್ರಿಸ್ಟನ್	ಕ ್ ರ ಿ ಸ ್ ಟ ನ ್ |
ಕ್ರೀಡೆ	ಕ ್ ರ ೀ ಡ ೆ |
ಕ್ರೋಂನ್ಜೇ	ಕ ್ ರ ೋ ಂ ನ ್ ಜ ೇ |
ಕ್ಲಿಷ್ಟ	ಕ ್ ಲ ಿ ಷ ್ ಟ |
ಕ್ಲೈವ್	ಕ ್ ಲ ೈ ವ ್ |
ಕ್ಷಣ	ಕ ್ ಷ ಣ |
ಕ್ಷೀಣಿಸುತ್ತದೆ	ಕ ್ ಷ ೀ ಣ ಿ ಸ ು ತ ್ ತ ದ ೆ |
ಕ್ಷೇತ್ರ	ಕ ್ ಷ ೇ ತ ್ ರ |
ಖಂಡಿತ	ಖ ಂ ಡ ಿ ತ |
ಖಚಿತ	ಖ ಚ ಿ ತ |
ಖಜಾನೆ	ಖ ಜ ಾ ನ ೆ |
ಖನ್ನಾ	ಖ ನ ್ ನ ಾ |
ಖಮ್ಮಮ್	ಖ ಮ ್ ಮ ಮ ್ |
ಖರೀದಿ	ಖ ರ ೀ ದ ಿ |
ಖರೀಮ್	ಖ ರ ೀ ಮ ್ |
ಖರ್ಗೆ	ಖ ರ ್ ಗ ೆ |
ಖರ್ಚು	ಖ ರ ್ ಚ ು |
ಖಾಂಭಟ್ಟಾ	ಖ ಾ ಂ ಭ ಟ ್ ಟ ಾ |
ಖಾತೆ	ಖ ಾ ತ ೆ |
ಖಾದರ್	ಖ ಾ ದ ರ ್ |
ಖಾಧೀರ್	ಖ ಾ ಧ ೀ ರ ್ |
ಖಾನ್	ಖ ಾ ನ ್ |
ಖಾಲಿ	ಖ ಾ ಲ ಿ |
ಖಾಲಿದ್	ಖ ಾ ಲ ಿ ದ ್ |
ಖಾಸಗಿ	ಖ ಾ ಸ ಗ ಿ |
ಖೀರಿ	ಖ ೀ ರ ಿ |
ಖುರ್ಜಾ	ಖ ು ರ ್ ಜ ಾ |
ಖೇರ್	ಖ ೇ ರ ್ |
ಖೋಡಾ	ಖ ೋ ಡ ಾ |
ಖ್ವಾಜಾ	ಖ ್ ವ ಾ ಜ ಾ |
ಗಂಗಾನಗರ್	ಗ ಂ ಗ ಾ ನ ಗ ರ ್ |
ಗಂಗೂಬಾಯಿ	ಗ ಂ ಗ ೂ ಬ ಾ ಯ ಿ |
ಗಂಗೂಲಿ	ಗ ಂ ಗ ೂ ಲ ಿ |
ಗಂಗ್	ಗ ಂ ಗ ್ |
ಗಂಜ್	ಗ ಂ ಜ ್ |
ಗಂಟಲು	ಗ ಂ ಟ ಲ ು |
ಗಂಟು	ಗ ಂ ಟ ು |
ಗಂಟೆ	ಗ ಂ ಟ ೆ |
ಗಂಟೆಗೆ	ಗ ಂ ಟ ೆ ಗ ೆ |
ಗಂಡ	ಗ ಂ ಡ |
ಗಂಡು	ಗ ಂ ಡ ು |
ಗಂಧರ್ವ	ಗ ಂ ಧ ರ ್ ವ |
ಗಂಭೀರ	ಗ ಂ ಭ ೀ ರ |
ಗಗನಕ್ಕೇರಿದೆ	ಗ ಗ ನ ಕ ್ ಕ ೇ ರ ಿ ದ ೆ |
ಗಗನ್	ಗ ಗ ನ ್ |
ಗಟ್ಟಿ	ಗ ಟ ್ ಟ ಿ |
ಗಡಿ	ಗ ಡ ಿ |
ಗಢ್	ಗ ಢ ್ |
ಗಣಪತ್	ಗ ಣ ಪ ತ ್ |
ಗಣೇಶ್	ಗ ಣ ೇ ಶ ್ |
ಗತಿ	ಗ ತ ಿ |
ಗದಗ	ಗ ದ ಗ |
ಗದ್ದ	ಗ ದ ್ ದ |
ಗದ್ದೆ	ಗ ದ ್ ದ ೆ |
ಗದ್ದೆಗಳಿಗೆ	ಗ ದ ್ ದ ೆ ಗ ಳ ಿ ಗ ೆ |
ಗದ್ದೆಯಲ್ಲಿ	ಗ ದ ್ ದ ೆ ಯ ಲ ್ ಲ ಿ |
ಗದ್ಯ	ಗ ದ ್ ಯ |
ಗಮನ	ಗ ಮ ನ |
ಗಯಾ	ಗ ಯ ಾ |
ಗರಿಷ್ಠ	ಗ ರ ಿ ಷ ್ ಠ |
ಗಲ್ಲ	ಗ ಲ ್ ಲ |
ಗಳಿಕೆ	ಗ ಳ ಿ ಕ ೆ |
ಗಳಿಸು	ಗ ಳ ಿ ಸ ು |
ಗವಾಸ್ಕರ್	ಗ ವ ಾ ಸ ್ ಕ ರ ್ |
ಗಾಂಧಿ	ಗ ಾ ಂ ಧ ಿ |
ಗಾಂಧಿನಗರ	ಗ ಾ ಂ ಧ ಿ ನ ಗ ರ |
ಗಾಂಧೀಜಿಯವರ	ಗ ಾ ಂ ಧ ೀ ಜ ಿ ಯ ವ ರ |
ಗಾಂವ್	ಗ ಾ ಂ ವ ್ |
ಗಾಝಿಪುರ್	ಗ ಾ ಝ ಿ ಪ ು ರ ್ |
ಗಾಡಿ	ಗ ಾ ಡ ಿ |
ಗಾಡಿಯನ್ನು	ಗ ಾ ಡ ಿ ಯ ನ ್ ನ ು |
ಗಾಢ	ಗ ಾ ಢ |
ಗಾದೆ	ಗ ಾ ದ ೆ |
ಗಾಮಾ	ಗ ಾ ಮ ಾ |
ಗಾಯ	ಗ ಾ ಯ |
ಗಾಯಕ್ವಾಡ್	ಗ ಾ ಯ ಕ ್ ವ ಾ ಡ ್ |
ಗಾಳಿ	ಗ ಾ ಳ ಿ |
ಗಾವ್	ಗ ಾ ವ ್ |
ಗಿಡ	ಗ ಿ ಡ |
ಗಿಡದ	ಗ ಿ ಡ ದ |
ಗಿಡವು	ಗ ಿ ಡ ವ ು |
ಗಿಪ್ಸ್	ಗ ಿ ಪ ್ ಸ ್ |
ಗಿರಿ	ಗ ಿ ರ ಿ |
ಗಿರಿಜಾ	ಗ ಿ ರ ಿ ಜ ಾ |
ಗಿರೀಡಿಹ್	ಗ ಿ ರ ೀ ಡ ಿ ಹ ್ |
ಗಿರೀಶ್	ಗ ಿ ರ ೀ ಶ ್ |
ಗಿಲ್ಕ್ರಿಸ್ಟ್	ಗ ಿ ಲ ್ ಕ ್ ರ ಿ ಸ ್ ಟ ್ |
ಗೀತೆ	ಗ ೀ ತ ೆ |
ಗುಂಟೂರ್	ಗ ು ಂ ಟ ೂ ರ ್ |
ಗುಂಡು	ಗ ು ಂ ಡ ು |
ಗುಂಡೂರಾವ್	ಗ ು ಂ ಡ ೂ ರ ಾ ವ ್ |
ಗುಂಡ್ಲುಪೇಟೆ	ಗ ು ಂ ಡ ್ ಲ ು ಪ ೇ ಟ ೆ |
ಗುಂಪು	ಗ ು ಂ ಪ ು |
ಗುಜ್ರಾಲ್	ಗ ು ಜ ್ ರ ಾ ಲ ್ |
ಗುಡಿ	ಗ ು ಡ ಿ |
ಗುಡಿಬಂಡ	ಗ ು ಡ ಿ ಬ ಂ ಡ |
ಗುಣ	ಗ ು ಣ |
ಗುಣಗಳನ್ನು	ಗ ು ಣ ಗ ಳ ನ ್ ನ ು |
ಗುಬ್ಬಚ್ಚಿ	ಗ ು ಬ ್ ಬ ಚ ್ ಚ ಿ |
ಗುಬ್ಬಚ್ಚಿಗಳ	ಗ ು ಬ ್ ಬ ಚ ್ ಚ ಿ ಗ ಳ |
ಗುಬ್ಬಿ	ಗ ು ಬ ್ ಬ ಿ |
ಗುಮ್ಲಾ	ಗ ು ಮ ್ ಲ ಾ |
ಗುರಿ	ಗ ು ರ ಿ |
ಗುರು	ಗ ು ರ ು |
ಗುರುತಿಸು	ಗ ು ರ ು ತ ಿ ಸ ು |
ಗುರುತು	ಗ ು ರ ು ತ ು |
ಗುರುದತ್	ಗ ು ರ ು ದ ತ ್ |
ಗುರುದಯಾಲ್	ಗ ು ರ ು ದ ಯ ಾ ಲ ್ |
ಗುರುದಾಸ್	ಗ ು ರ ು ದ ಾ ಸ ್ |
ಗುರುವಾರ	ಗ ು ರ ು ವ ಾ ರ |
ಗುರ್	ಗ ು ರ ್ |
ಗುಲಬರ್ಗ	ಗ ು ಲ ಬ ರ ್ ಗ |
ಗುಲಾಬಿ	ಗ ು ಲ ಾ ಬ ಿ |
ಗುಲಾಮ್	ಗ ು ಲ ಾ ಮ ್ |
ಗುಲ್ಷನ್	ಗ ು ಲ ್ ಷ ನ ್ |
ಗುಹೆ	ಗ ು ಹ ೆ |
ಗೂಚಾ	ಗ ೂ ಚ ಾ |
ಗೂಟ	ಗ ೂ ಟ |
ಗೂಬೆ	ಗ ೂ ಬ ೆ |
ಗೂಬೆಗೆ	ಗ ೂ ಬ ೆ ಗ ೆ |
ಗೂಳಿ	ಗ ೂ ಳ ಿ |
ಗೆಜ್ಜಲಗೆರೆ	ಗ ೆ ಜ ್ ಜ ಲ ಗ ೆ ರ ೆ |
ಗೆದ್ದೆ	ಗ ೆ ದ ್ ದ ೆ |
ಗೆಲುವು	ಗ ೆ ಲ ು ವ ು |
ಗೆಲ್ಲು	ಗ ೆ ಲ ್ ಲ ು |
ಗೆಲ್ಲುತೇನೆ	ಗ ೆ ಲ ್ ಲ ು ತ ೇ ನ ೆ |
ಗೆಲ್ಲುವುದು	ಗ ೆ ಲ ್ ಲ ು ವ ು ದ ು |
ಗೆಳೆಯ	ಗ ೆ ಳ ೆ ಯ |
ಗೇರಿ	ಗ ೇ ರ ಿ |
ಗೊಂಡಾ	ಗ ೊ ಂ ಡ ಾ |
ಗೊಂದಲ	ಗ ೊ ಂ ದ ಲ |
ಗೊಂಬೆ	ಗ ೊ ಂ ಬ ೆ |
ಗೊಡ್ಡ	ಗ ೊ ಡ ್ ಡ |
ಗೊತ್ತಿಲ್ಲ	ಗ ೊ ತ ್ ತ ಿ ಲ ್ ಲ |
ಗೊತ್ತು	ಗ ೊ ತ ್ ತ ು |
ಗೊಪಾಲ್	ಗ ೊ ಪ ಾ ಲ ್ |
ಗೊಬ್ಬರ	ಗ ೊ ಬ ್ ಬ ರ |
ಗೊಬ್ಬರವಾಗಿ	ಗ ೊ ಬ ್ ಬ ರ ವ ಾ ಗ ಿ |
ಗೊರಕ್	ಗ ೊ ರ ಕ ್ |
ಗೊಲ್	ಗ ೊ ಲ ್ |
ಗೋಕಕ್	ಗ ೋ ಕ ಕ ್ |
ಗೋಕರ್ಣ	ಗ ೋ ಕ ರ ್ ಣ |
ಗೋಕಾಕ್	ಗ ೋ ಕ ಾ ಕ ್ |
ಗೋಡೆ	ಗ ೋ ಡ ೆ |
ಗೋಧಿ	ಗ ೋ ಧ ಿ |
ಗೋಧಿಯನ್ನು	ಗ ೋ ಧ ಿ ಯ ನ ್ ನ ು |
ಗೋಪಾಲ	ಗ ೋ ಪ ಾ ಲ |
ಗೋಯಲ್	ಗ ೋ ಯ ಲ ್ |
ಗೋರೆ	ಗ ೋ ರ ೆ |
ಗೋಲು	ಗ ೋ ಲ ು |
ಗೋವರ್	ಗ ೋ ವ ರ ್ |
ಗೋವಾ	ಗ ೋ ವ ಾ |
ಗೋವಿಂದ	ಗ ೋ ವ ಿ ಂ ದ |
ಗೌಂಡಮಣಿ	ಗ ೌ ಂ ಡ ಮ ಣ ಿ |
ಗೌರವ	ಗ ೌ ರ ವ |
ಗೌರವ್	ಗ ೌ ರ ವ ್ |
ಗೌರಿಬಿದನೂರು	ಗ ೌ ರ ಿ ಬ ಿ ದ ನ ೂ ರ ು |
ಗೌಹಾತಿ	ಗ ೌ ಹ ಾ ತ ಿ |
ಗ್ರಂಥ	ಗ ್ ರ ಂ ಥ |
ಗ್ರಹ	ಗ ್ ರ ಹ |
ಗ್ರಹಮ್	ಗ ್ ರ ಹ ಮ ್ |
ಗ್ರಾಮ	ಗ ್ ರ ಾ ಮ |
ಗ್ರಾಮಾಂತರ	ಗ ್ ರ ಾ ಮ ಾ ಂ ತ ರ |
ಗ್ರಾಮೀಣ	ಗ ್ ರ ಾ ಮ ೀ ಣ |
ಗ್ರಾಹಕ	ಗ ್ ರ ಾ ಹ ಕ |
ಗ್ರೀಷ್ಮ	ಗ ್ ರ ೀ ಷ ್ ಮ |
ಗ್ರೇಗ್	ಗ ್ ರ ೇ ಗ ್ |
ಗ್ರೇಟ್	ಗ ್ ರ ೇ ಟ ್ |
ಗ್ವಾಲಿಯರ್	ಗ ್ ವ ಾ ಲ ಿ ಯ ರ ್ |
ಘಟಕ	ಘ ಟ ಕ |
ಘಟನೆ	ಘ ಟ ನ ೆ |
ಘಟಮ್	ಘ ಟ ಮ ್ |
ಘಟಾಶಿಲಾ	ಘ ಟ ಾ ಶ ಿ ಲ ಾ |
ಘನ	ಘ ನ |
ಘಾಟು	ಘ ಾ ಟ ು |
ಘೋರ	ಘ ೋ ರ |
ಘೋಷಣೆ	ಘ ೋ ಷ ಣ ೆ |
ಚಂಢೀಗಢ	ಚ ಂ ಢ ೀ ಗ ಢ |
ಚಂದ್ರ	ಚ ಂ ದ ್ ರ |
ಚಂದ್ರಪೌಲ್	ಚ ಂ ದ ್ ರ ಪ ೌ ಲ ್ |
ಚಂದ್ರಶೇಖರ್	ಚ ಂ ದ ್ ರ ಶ ೇ ಖ ರ ್ |
ಚಂದ್ರು	ಚ ಂ ದ ್ ರ ು |
ಚಂಪಾವತ್	ಚ ಂ ಪ ಾ ವ ತ ್ |
ಚಕ್ರವರ್ತಿ	ಚ ಕ ್ ರ ವ ರ ್ ತ ಿ |
ಚಟಗಳೆಲ್ಲವನ್ನೂ	ಚ ಟ ಗ ಳ ೆ ಲ ್ ಲ ವ ನ ್ ನ ೂ |
ಚಟುವಟಿಕೆ	ಚ ಟ ು ವ ಟ ಿ ಕ ೆ |
ಚತ್ರಾ	ಚ ತ ್ ರ ಾ |
ಚದುರಂಗ	ಚ ದ ು ರ ಂ ಗ |
ಚನ್ನಗಿರಿ	ಚ ನ ್ ನ ಗ ಿ ರ ಿ |
ಚನ್ನಪಟ್ಟಣ	ಚ ನ ್ ನ ಪ ಟ ್ ಟ ಣ |
ಚನ್ನಮ್ಮ	ಚ ನ ್ ನ ಮ ್ ಮ |
ಚನ್ನರಾಯಪಟ್ಟಣ	ಚ ನ ್ ನ ರ ಾ ಯ ಪ ಟ ್ ಟ ಣ |
ಚನ್ಲಾಂಗ್	ಚ ನ ್ ಲ ಾ ಂ ಗ ್ |
ಚಪಾತಿ	ಚ ಪ ಾ ತ ಿ |
ಚಮಿಂದಾವಾಸ್	ಚ ಮ ಿ ಂ ದ ಾ ವ ಾ ಸ ್ |
ಚರಣ್	ಚ ರ ಣ ್ |
ಚರದ್	ಚ ರ ದ ್ |
ಚರಿತ್ರೆ	ಚ ರ ಿ ತ ್ ರ ೆ |
ಚರ್	ಚ ರ ್ |
ಚರ್ಚೆ	ಚ ರ ್ ಚ ೆ |
ಚರ್ಮ	ಚ ರ ್ ಮ |
ಚಳಿ	ಚ ಳ ಿ |
ಚಳಿಗಾಲ	ಚ ಳ ಿ ಗ ಾ ಲ |
ಚಳಿಗಾಲದಲ್ಲಿ	ಚ ಳ ಿ ಗ ಾ ಲ ದ ಲ ್ ಲ ಿ |
ಚಳುವಳಿ	ಚ ಳ ು ವ ಳ ಿ |
ಚಳ್ಳಕೆರೆ	ಚ ಳ ್ ಳ ಕ ೆ ರ ೆ |
ಚಾಂದಿನಿ	ಚ ಾ ಂ ದ ಿ ನ ಿ |
ಚಾಕು	ಚ ಾ ಕ ು |
ಚಾಕ್ರಿ	ಚ ಾ ಕ ್ ರ ಿ |
ಚಾಪಲ್	ಚ ಾ ಪ ಲ ್ |
ಚಾಪೆ	ಚ ಾ ಪ ೆ |
ಚಾಪೆಗಳು	ಚ ಾ ಪ ೆ ಗ ಳ ು |
ಚಾಪೆಲ್	ಚ ಾ ಪ ೆ ಲ ್ |
ಚಾಪ್ಲಿನ್	ಚ ಾ ಪ ್ ಲ ಿ ನ ್ |
ಚಾಮರಾಜನಗರ	ಚ ಾ ಮ ರ ಾ ಜ ನ ಗ ರ |
ಚಾರ್ಲಿ	ಚ ಾ ರ ್ ಲ ಿ |
ಚಿಂಚೋಲಿ	ಚ ಿ ಂ ಚ ೋ ಲ ಿ |
ಚಿಂತನೆ	ಚ ಿ ಂ ತ ನ ೆ |
ಚಿಂತಾಮಣಿ	ಚ ಿ ಂ ತ ಾ ಮ ಣ ಿ |
ಚಿಂತೆ	ಚ ಿ ಂ ತ ೆ |
ಚಿಕಿತ್ಸೆ	ಚ ಿ ಕ ಿ ತ ್ ಸ ೆ |
ಚಿಕ್ಕ	ಚ ಿ ಕ ್ ಕ |
ಚಿಕ್ಕದೇವರಾಯ	ಚ ಿ ಕ ್ ಕ ದ ೇ ವ ರ ಾ ಯ |
ಚಿಕ್ಕನಾಯಕನಹಳ್ಳಿ	ಚ ಿ ಕ ್ ಕ ನ ಾ ಯ ಕ ನ ಹ ಳ ್ ಳ ಿ |
ಚಿಕ್ಕಪ್ಪ	ಚ ಿ ಕ ್ ಕ ಪ ್ ಪ |
ಚಿಕ್ಕಬಳ್ಳಾಪುರ	ಚ ಿ ಕ ್ ಕ ಬ ಳ ್ ಳ ಾ ಪ ು ರ |
ಚಿಕ್ಕಮಂಗಳೂರು	ಚ ಿ ಕ ್ ಕ ಮ ಂ ಗ ಳ ೂ ರ ು |
ಚಿಕ್ಕಮ್ಮ	ಚ ಿ ಕ ್ ಕ ಮ ್ ಮ |
ಚಿಟಪುರ	ಚ ಿ ಟ ಪ ು ರ |
ಚಿತ್ತಾಲ	ಚ ಿ ತ ್ ತ ಾ ಲ |
ಚಿತ್ರ	ಚ ಿ ತ ್ ರ |
ಚಿತ್ರಣ	ಚ ಿ ತ ್ ರ ಣ |
ಚಿತ್ರಿಸು	ಚ ಿ ತ ್ ರ ಿ ಸ ು |
ಚಿನ್ನ	ಚ ಿ ನ ್ ನ |
ಚಿಪ್	ಚ ಿ ಪ ್ |
ಚಿರಂಜೀವಿ	ಚ ಿ ರ ಂ ಜ ೀ ವ ಿ |
ಚಿಶ್ತಿ	ಚ ಿ ಶ ್ ತ ಿ |
ಚೀಲ	ಚ ೀ ಲ |
ಚುನಾರ್	ಚ ು ನ ಾ ರ ್ |
ಚುನಾವಣೆ	ಚ ು ನ ಾ ವ ಣ ೆ |
ಚೂಡಚಂದ್	ಚ ೂ ಡ ಚ ಂ ದ ್ |
ಚೂರ್	ಚ ೂ ರ ್ |
ಚೆಂಡು	ಚ ೆ ಂ ಡ ು |
ಚೆನ್ನಾಗಿ	ಚ ೆ ನ ್ ನ ಾ ಗ ಿ |
ಚೆನ್ನಾಗಿರುತ್ತದೆ	ಚ ೆ ನ ್ ನ ಾ ಗ ಿ ರ ು ತ ್ ತ ದ ೆ |
ಚೆನ್ನೈ	ಚ ೆ ನ ್ ನ ೈ |
ಚೇತನ್	ಚ ೇ ತ ನ ್ |
ಚೈತ್ರ	ಚ ೈ ತ ್ ರ |
ಚೊಪನ್	ಚ ೊ ಪ ನ ್ |
ಚೋಪ್ರ	ಚ ೋ ಪ ್ ರ |
ಚೋಪ್ರಾ	ಚ ೋ ಪ ್ ರ ಾ |
ಚೌಡಯ್ಯ	ಚ ೌ ಡ ಯ ್ ಯ |
ಚೌಧರಿ	ಚ ೌ ಧ ರ ಿ |
ಛಂಕಿ	ಛ ಂ ಕ ಿ |
ಛತ್ರಿ	ಛ ತ ್ ರ ಿ |
ಛಾಯ	ಛ ಾ ಯ |
ಛಾಯಾ	ಛ ಾ ಯ ಾ |
ಛಿಂದ್ವಾಡ	ಛ ಿ ಂ ದ ್ ವ ಾ ಡ |
ಛಿನ್ನ	ಛ ಿ ನ ್ ನ |
ಜಂಗ್	ಜ ಂ ಗ ್ |
ಜಂತಿ	ಜ ಂ ತ ಿ |
ಜಂಶೆಡ್	ಜ ಂ ಶ ೆ ಡ ್ |
ಜಗತ್ತು	ಜ ಗ ತ ್ ತ ು |
ಜಗದೀಶ್	ಜ ಗ ದ ೀ ಶ ್ |
ಜಗಮೋಹನ್	ಜ ಗ ಮ ೋ ಹ ನ ್ |
ಜಗಲೂರು	ಜ ಗ ಲ ೂ ರ ು |
ಜಗಳ	ಜ ಗ ಳ |
ಜಗಳಮಾಡುತ್ತಾರೆ	ಜ ಗ ಳ ಮ ಾ ಡ ು ತ ್ ತ ಾ ರ ೆ |
ಜಗಳವಾಡಿದರು	ಜ ಗ ಳ ವ ಾ ಡ ಿ ದ ರ ು |
ಜಗಳವಾಡುತ್ತಾಳೆ	ಜ ಗ ಳ ವ ಾ ಡ ು ತ ್ ತ ಾ ಳ ೆ |
ಜಗಳವಾದರೆ	ಜ ಗ ಳ ವ ಾ ದ ರ ೆ |
ಜಗ್ಗೇಶ್	ಜ ಗ ್ ಗ ೇ ಶ ್ |
ಜಡೆ	ಜ ಡ ೆ |
ಜಡೇಜಾ	ಜ ಡ ೇ ಜ ಾ |
ಜತೆ	ಜ ತ ೆ |
ಜತ್ತಿ	ಜ ತ ್ ತ ಿ |
ಜನ	ಜ ನ |
ಜನತಾದಳ	ಜ ನ ತ ಾ ದ ಳ |
ಜನತೆ	ಜ ನ ತ ೆ |
ಜನಪದ	ಜ ನ ಪ ದ |
ಜನಪ್ರಿಯ	ಜ ನ ಪ ್ ರ ಿ ಯ |
ಜನವರಿ	ಜ ನ ವ ರ ಿ |
ಜನಸಾಮಾನ್ಯ	ಜ ನ ಸ ಾ ಮ ಾ ನ ್ ಯ |
ಜನಾಂಗ	ಜ ನ ಾ ಂ ಗ |
ಜನ್ನ	ಜ ನ ್ ನ |
ಜನ್ಮ	ಜ ನ ್ ಮ |
ಜಬಲ್	ಜ ಬ ಲ ್ |
ಜಮಖಂಡಿ	ಜ ಮ ಖ ಂ ಡ ಿ |
ಜಮ್ಮು	ಜ ಮ ್ ಮ ು |
ಜಯ	ಜ ಯ |
ಜಯಚಾಮರಾಜೇಂದ್ರ	ಜ ಯ ಚ ಾ ಮ ರ ಾ ಜ ೇ ಂ ದ ್ ರ |
ಜಯದೇವಿತಾಯಿ	ಜ ಯ ದ ೇ ವ ಿ ತ ಾ ಯ ಿ |
ಜಯಮಾಲ	ಜ ಯ ಮ ಾ ಲ |
ಜಯಸೂರ್ಯ	ಜ ಯ ಸ ೂ ರ ್ ಯ |
ಜಯಾ	ಜ ಯ ಾ |
ಜಯ್	ಜ ಯ ್ |
ಜಲಂಧರ್	ಜ ಲ ಂ ಧ ರ ್ |
ಜಲ್	ಜ ಲ ್ |
ಜವಹರಲಾಲ್	ಜ ವ ಹ ರ ಲ ಾ ಲ ್ |
ಜವಾಬ್ದಾರಿ	ಜ ವ ಾ ಬ ್ ದ ಾ ರ ಿ |
ಜಶ್	ಜ ಶ ್ |
ಜಹೀರ	ಜ ಹ ೀ ರ |
ಜಾಕೀಚಾನ್	ಜ ಾ ಕ ೀ ಚ ಾ ನ ್ |
ಜಾಕೀಶ್ರಾಫ್	ಜ ಾ ಕ ೀ ಶ ್ ರ ಾ ಫ ್ |
ಜಾಕ್ಕರ್	ಜ ಾ ಕ ್ ಕ ರ ್ |
ಜಾಕ್ಸನ್	ಜ ಾ ಕ ್ ಸ ನ ್ |
ಜಾಖಿರ್	ಜ ಾ ಖ ಿ ರ ್ |
ಜಾಗ	ಜ ಾ ಗ |
ಜಾಣ	ಜ ಾ ಣ |
ಜಾತಿ	ಜ ಾ ತ ಿ |
ಜಾತಿಗೆ	ಜ ಾ ತ ಿ ಗ ೆ |
ಜಾತ್ಯತೀತ	ಜ ಾ ತ ್ ಯ ತ ೀ ತ |
ಜಾತ್ರೆ	ಜ ಾ ತ ್ ರ ೆ |
ಜಾತ್ರೆಗೆ	ಜ ಾ ತ ್ ರ ೆ ಗ ೆ |
ಜಾನಪದ	ಜ ಾ ನ ಪ ದ |
ಜಾನೀ	ಜ ಾ ನ ೀ |
ಜಾಫರ್	ಜ ಾ ಫ ರ ್ |
ಜಾಫ್ರಿ	ಜ ಾ ಫ ್ ರ ಿ |
ಜಾಮ್	ಜ ಾ ಮ ್ |
ಜಾರಿ	ಜ ಾ ರ ಿ |
ಜಾರ್ಜ್	ಜ ಾ ರ ್ ಜ ್ |
ಜಾವಗಲ್	ಜ ಾ ವ ಗ ಲ ್ |
ಜಾವಿದ್	ಜ ಾ ವ ಿ ದ ್ |
ಜಿ	ಜ ಿ |
ಜಿಂಕೆ	ಜ ಿ ಂ ಕ ೆ |
ಜಿತೇಂದ್ರ	ಜ ಿ ತ ೇ ಂ ದ ್ ರ |
ಜಿನ್ನಾ	ಜ ಿ ನ ್ ನ ಾ |
ಜಿಯಾಉಲ್	ಜ ಿ ಯ ಾ ಉ ಲ ್ |
ಜಿಲ್ಲೆ	ಜ ಿ ಲ ್ ಲ ೆ |
ಜೀವ	ಜ ೀ ವ |
ಜೀವಂತ	ಜ ೀ ವ ಂ ತ |
ಜೀವನ	ಜ ೀ ವ ನ |
ಜೀವಿ	ಜ ೀ ವ ಿ |
ಜುಲೈ	ಜ ು ಲ ೈ |
ಜುಲ್ಫೀಕರ್	ಜ ು ಲ ್ ಫ ೀ ಕ ರ ್ |
ಜೂನ್	ಜ ೂ ನ ್ |
ಜೆ	ಜ ೆ |
ಜೇಕ್	ಜ ೇ ಕ ್ |
ಜೇವರ್ಗಿ	ಜ ೇ ವ ರ ್ ಗ ಿ |
ಜೇಷ್ಠ	ಜ ೇ ಷ ್ ಠ |
ಜೈನ	ಜ ೈ ನ |
ಜೈಲ್ಸಿಂಗ್	ಜ ೈ ಲ ್ ಸ ಿ ಂ ಗ ್ |
ಜೈಸಲ್	ಜ ೈ ಸ ಲ ್ |
ಜೊತೆ	ಜ ೊ ತ ೆ |
ಜೊತೆಗೆ	ಜ ೊ ತ ೆ ಗ ೆ |
ಜೊವಾಯ್	ಜ ೊ ವ ಾ ಯ ್ |
ಜೋಡಿ	ಜ ೋ ಡ ಿ |
ಜೋಧ್	ಜ ೋ ಧ ್ |
ಜೋಷಿ	ಜ ೋ ಷ ಿ |
ಜ್ಞಾನ	ಜ ್ ಞ ಾ ನ |
ಜ್ಞಾನಿ	ಜ ್ ಞ ಾ ನ ಿ |
ಜ್ಞಾನೇಂದ್ರ್	ಜ ್ ಞ ಾ ನ ೇ ಂ ದ ್ ರ ್ |
ಜ್ಯೋತಿ	ಜ ್ ಯ ೋ ತ ಿ |
ಜ್ವರ	ಜ ್ ವ ರ |
ಝರಿ	ಝ ರ ಿ |
ಝಾಡಿಸು	ಝ ಾ ಡ ಿ ಸ ು |
ಝಾನ್ಸಿ	ಝ ಾ ನ ್ ಸ ಿ |
ಝಾರಿಯಾ	ಝ ಾ ರ ಿ ಯ ಾ |
ಝಾರ್	ಝ ಾ ರ ್ |
ಝುನು	ಝ ು ನ ು |
ಝುನ್	ಝ ು ನ ್ |
ಟಂಡನ್	ಟ ಂ ಡ ನ ್ |
ಟಗರು	ಟ ಗ ರ ು |
ಟಪಾಲು	ಟ ಪ ಾ ಲ ು |
ಟಾಟಾನಗರ	ಟ ಾ ಟ ಾ ನ ಗ ರ |
ಟಿ	ಟ ಿ |
ಟಿಟ್	ಟ ಿ ಟ ್ |
ಟಿಪ್ಪು	ಟ ಿ ಪ ್ ಪ ು |
ಟೀಕಮ್	ಟ ೀ ಕ ಮ ್ |
ಟೀಕೆ	ಟ ೀ ಕ ೆ |
ಟೀನು	ಟ ೀ ನ ು |
ಟೊಕ್	ಟ ೊ ಕ ್ |
ಟೋನಿ	ಟ ೋ ನ ಿ |
ಟೋಪಿ	ಟ ೋ ಪ ಿ |
ಟ್ಯುಟಿಕಾರನ್	ಟ ್ ಯ ು ಟ ಿ ಕ ಾ ರ ನ ್ |
ಠಕ್ಕ	ಠ ಕ ್ ಕ |
ಠಾಣೆ	ಠ ಾ ಣ ೆ |
ಠಾನೆ	ಠ ಾ ನ ೆ |
ಠೀವಿ	ಠ ೀ ವ ಿ |
ಡಬ್ಬ	ಡ ಬ ್ ಬ |
ಡಬ್ಬದಲ್ಲಿ	ಡ ಬ ್ ಬ ದ ಲ ್ ಲ ಿ |
ಡಬ್ಲ್ಯು	ಡ ಬ ್ ಲ ್ ಯ ು |
ಡಬ್ಲ್ಯೂ	ಡ ಬ ್ ಲ ್ ಯ ೂ |
ಡಾ	ಡ ಾ |
ಡಾನ್	ಡ ಾ ನ ್ |
ಡಾಬನ್ನು	ಡ ಾ ಬ ನ ್ ನ ು |
ಡಾಬು	ಡ ಾ ಬ ು |
ಡಾರ್ಜಿಲಿಂಗ್	ಡ ಾ ರ ್ ಜ ಿ ಲ ಿ ಂ ಗ ್ |
ಡಿ	ಡ ಿ |
ಡಿಯೋಲ್	ಡ ಿ ಯ ೋ ಲ ್ |
ಡಿವಿಜಿ	ಡ ಿ ವ ಿ ಜ ಿ |
ಡಿಸೆಂಬರ್	ಡ ಿ ಸ ೆ ಂ ಬ ರ ್ |
ಡುಬ್ಬ	ಡ ು ಬ ್ ಬ |
ಡೆ	ಡ ೆ |
ಡೇವಿಡ್	ಡ ೇ ವ ಿ ಡ ್ |
ಡೊನಾಲ್ಡ್	ಡ ೊ ನ ಾ ಲ ್ ಡ ್ |
ಡೋಲು	ಡ ೋ ಲ ು |
ಢಕ್ಕೆ	ಢ ಕ ್ ಕ ೆ |
ಢಮರುಗ	ಢ ಮ ರ ು ಗ |
ತಂಗಿ	ತ ಂ ಗ ಿ |
ತಂಜಾವೂರ್	ತ ಂ ಜ ಾ ವ ೂ ರ ್ |
ತಂಡ	ತ ಂ ಡ |
ತಂತ್ರ	ತ ಂ ತ ್ ರ |
ತಂತ್ರಜ್ಞಾನ	ತ ಂ ತ ್ ರ ಜ ್ ಞ ಾ ನ |
ತಂದ	ತ ಂ ದ |
ತಂದೆ	ತ ಂ ದ ೆ |
ತಂದ್ದದು	ತ ಂ ದ ್ ದ ದ ು |
ತಂಪು	ತ ಂ ಪ ು |
ತಕ್ಕ	ತ ಕ ್ ಕ |
ತಕ್ಷಣ	ತ ಕ ್ ಷ ಣ |
ತಗೊಂಡು	ತ ಗ ೊ ಂ ಡ ು |
ತಗೊಳ್ಳಿ	ತ ಗ ೊ ಳ ್ ಳ ಿ |
ತಗೋ	ತ ಗ ೋ |
ತಗೋಬೇಡ	ತ ಗ ೋ ಬ ೇ ಡ |
ತಜ್ಞ	ತ ಜ ್ ಞ |
ತಟ್ಟೆ	ತ ಟ ್ ಟ ೆ |
ತಟ್ಟೆಯಲ್ಲಿ	ತ ಟ ್ ಟ ೆ ಯ ಲ ್ ಲ ಿ |
ತಡೆ	ತ ಡ ೆ |
ತಣ್ಣನೆ	ತ ಣ ್ ಣ ನ ೆ |
ತತ್ತ್ವ	ತ ತ ್ ತ ್ ವ |
ತನಕ	ತ ನ ಕ |
ತನಗೆ	ತ ನ ಗ ೆ |
ತನಿಖೆ	ತ ನ ಿ ಖ ೆ |
ತನ್ನ	ತ ನ ್ ನ |
ತಪ್ಪಲೆ	ತ ಪ ್ ಪ ಲ ೆ |
ತಪ್ಪು	ತ ಪ ್ ಪ ು |
ತಮ್ಮ	ತ ಮ ್ ಮ |
ತಯಾರಿಸು	ತ ಯ ಾ ರ ಿ ಸ ು |
ತರಕಾರಿ	ತ ರ ಕ ಾ ರ ಿ |
ತರಗತಿ	ತ ರ ಗ ತ ಿ |
ತರಬೇತಿ	ತ ರ ಬ ೇ ತ ಿ |
ತರೀಕೆರೆ	ತ ರ ೀ ಕ ೆ ರ ೆ |
ತರು	ತ ರ ು |
ತಲ	ತ ಲ |
ತಲಕಾಡು	ತ ಲ ಕ ಾ ಡ ು |
ತಲಾ	ತ ಲ ಾ |
ತಲುಪು	ತ ಲ ು ಪ ು |
ತಲೆ	ತ ಲ ೆ |
ತಲೆಬುರುಡೆ	ತ ಲ ೆ ಬ ು ರ ು ಡ ೆ |
ತಲೆಯಿಂದ	ತ ಲ ೆ ಯ ಿ ಂ ದ |
ತಾ	ತ ಾ |
ತಾಂತ್ರಿಕ	ತ ಾ ಂ ತ ್ ರ ಿ ಕ |
ತಾಂಬ್ರಮ್	ತ ಾ ಂ ಬ ್ ರ ಮ ್ |
ತಾಟ್ಚರ್	ತ ಾ ಟ ್ ಚ ರ ್ |
ತಾತ್ವಿಕ	ತ ಾ ತ ್ ವ ಿ ಕ |
ತಾನು	ತ ಾ ನ ು |
ತಾಪಾ	ತ ಾ ಪ ಾ |
ತಾಮ್ರ	ತ ಾ ಮ ್ ರ |
ತಾಯಿ	ತ ಾ ಯ ಿ |
ತಾರ	ತ ಾ ರ |
ತಾರೆ	ತ ಾ ರ ೆ |
ತಾಲ್ಲೂಕು	ತ ಾ ಲ ್ ಲ ೂ ಕ ು |
ತಾಳ್ಮೆ	ತ ಾ ಳ ್ ಮ ೆ |
ತಾವು	ತ ಾ ವ ು |
ತಿಂಗಳ	ತ ಿ ಂ ಗ ಳ |
ತಿಂಗಳು	ತ ಿ ಂ ಗ ಳ ು |
ತಿಂದ	ತ ಿ ಂ ದ |
ತಿನ್	ತ ಿ ನ ್ |
ತಿನ್ನಬೇಡ	ತ ಿ ನ ್ ನ ಬ ೇ ಡ |
ತಿನ್ನಲು	ತ ಿ ನ ್ ನ ಲ ು |
ತಿನ್ನಿ	ತ ಿ ನ ್ ನ ಿ |
ತಿನ್ನು	ತ ಿ ನ ್ ನ ು |
ತಿನ್ನುವುದರಿಂದ	ತ ಿ ನ ್ ನ ು ವ ು ದ ರ ಿ ಂ ದ |
ತಿನ್ನೋದು	ತ ಿ ನ ್ ನ ೋ ದ ು |
ತಿಪಟೂರು	ತ ಿ ಪ ಟ ೂ ರ ು |
ತಿರುಗಬೇಡ	ತ ಿ ರ ು ಗ ಬ ೇ ಡ |
ತಿರುಗಿ	ತ ಿ ರ ು ಗ ಿ |
ತಿರುಗು	ತ ಿ ರ ು ಗ ು |
ತಿರುಚಿ	ತ ಿ ರ ು ಚ ಿ |
ತಿರುನೇಲ್	ತ ಿ ರ ು ನ ೇ ಲ ್ |
ತಿರುಮಕೂಡಲ	ತ ಿ ರ ು ಮ ಕ ೂ ಡ ಲ |
ತಿಳಿ	ತ ಿ ಳ ಿ |
ತಿಳಿದಿದ್ದೇ	ತ ಿ ಳ ಿ ದ ಿ ದ ್ ದ ೇ |
ತಿಳಿದುಕೊಂಡಿದ್ದರೆ	ತ ಿ ಳ ಿ ದ ು ಕ ೊ ಂ ಡ ಿ ದ ್ ದ ರ ೆ |
ತಿಳಿಯದೆ	ತ ಿ ಳ ಿ ಯ ದ ೆ |
ತಿಳಿಸಲು	ತ ಿ ಳ ಿ ಸ ಲ ು |
ತಿಳಿಸು	ತ ಿ ಳ ಿ ಸ ು |
ತೀರ	ತ ೀ ರ |
ತೀರ್ಥಹಳ್ಳಿ	ತ ೀ ರ ್ ಥ ಹ ಳ ್ ಳ ಿ |
ತೀರ್ಪು	ತ ೀ ರ ್ ಪ ು |
ತೀರ್ಮಾನ	ತ ೀ ರ ್ ಮ ಾ ನ |
ತೀವ್ರ	ತ ೀ ವ ್ ರ |
ತುಂಡು	ತ ು ಂ ಡ ು |
ತುಂಬ	ತ ು ಂ ಬ |
ತುಂಬಿ	ತ ು ಂ ಬ ಿ |
ತುಂಬು	ತ ು ಂ ಬ ು |
ತುಟಿ	ತ ು ಟ ಿ |
ತುಪ್ಪ	ತ ು ಪ ್ ಪ |
ತುಮಕೂರು	ತ ು ಮ ಕ ೂ ರ ು |
ತುಮಕೂರ್	ತ ು ಮ ಕ ೂ ರ ್ |
ತುಯೆನ್	ತ ು ಯ ೆ ನ ್ |
ತುರಾ	ತ ು ರ ಾ |
ತುರುವೇಕೆರೆ	ತ ು ರ ು ವ ೇ ಕ ೆ ರ ೆ |
ತುರ್ತಾದ	ತ ು ರ ್ ತ ಾ ದ |
ತುಲಸಿ	ತ ು ಲ ಸ ಿ |
ತುಲಾ	ತ ು ಲ ಾ |
ತುಲ್ಲಾ	ತ ು ಲ ್ ಲ ಾ |
ತುಸು	ತ ು ಸ ು |
ತೂಕ	ತ ೂ ಕ |
ತೂಗು	ತ ೂ ಗ ು |
ತೃತೀಯ	ತ ೃ ತ ೀ ಯ |
ತೃಪ್ತಿ	ತ ೃ ಪ ್ ತ ಿ |
ತೆಂಗಿನಕಾಯಿ	ತ ೆ ಂ ಗ ಿ ನ ಕ ಾ ಯ ಿ |
ತೆಂಡುಲ್ಕರ್	ತ ೆ ಂ ಡ ು ಲ ್ ಕ ರ ್ |
ತೆಗೆ	ತ ೆ ಗ ೆ |
ತೆಗೆದುಕೊಂಡು	ತ ೆ ಗ ೆ ದ ು ಕ ೊ ಂ ಡ ು |
ತೆಗೆಯಲು	ತ ೆ ಗ ೆ ಯ ಲ ು |
ತೆಗೆಯುತ್ತಾರೆ	ತ ೆ ಗ ೆ ಯ ು ತ ್ ತ ಾ ರ ೆ |
ತೆನೆ	ತ ೆ ನ ೆ |
ತೆರಳು	ತ ೆ ರ ಳ ು |
ತೆರಿಗೆ	ತ ೆ ರ ಿ ಗ ೆ |
ತೆರೆ	ತ ೆ ರ ೆ |
ತೆಲುಗು	ತ ೆ ಲ ು ಗ ು |
ತೆಲ್ಗೀ	ತ ೆ ಲ ್ ಗ ೀ |
ತೆಳು	ತ ೆ ಳ ು |
ತೇಜಸ್ವಿನಿ	ತ ೇ ಜ ಸ ್ ವ ಿ ನ ಿ |
ತೇಜ್	ತ ೇ ಜ ್ |
ತೇರು	ತ ೇ ರ ು |
ತೊಂದರೆ	ತ ೊ ಂ ದ ರ ೆ |
ತೊಂಬತ್ತನಾಲ್ಕು	ತ ೊ ಂ ಬ ತ ್ ತ ನ ಾ ಲ ್ ಕ ು |
ತೊಂಬತ್ತಮೂರು	ತ ೊ ಂ ಬ ತ ್ ತ ಮ ೂ ರ ು |
ತೊಂಬತ್ತಾರು	ತ ೊ ಂ ಬ ತ ್ ತ ಾ ರ ು |
ತೊಂಬತ್ತು	ತ ೊ ಂ ಬ ತ ್ ತ ು |
ತೊಂಬತ್ತೆಂಟು	ತ ೊ ಂ ಬ ತ ್ ತ ೆ ಂ ಟ ು |
ತೊಂಬತ್ತೆರಡು	ತ ೊ ಂ ಬ ತ ್ ತ ೆ ರ ಡ ು |
ತೊಂಬತ್ತೇಳು	ತ ೊ ಂ ಬ ತ ್ ತ ೇ ಳ ು |
ತೊಂಬತ್ತೈದು	ತ ೊ ಂ ಬ ತ ್ ತ ೈ ದ ು |
ತೊಂಬತ್ತೊಂದು	ತ ೊ ಂ ಬ ತ ್ ತ ೊ ಂ ದ ು |
ತೊಂಬತ್ತೊಂಬತ್ತು	ತ ೊ ಂ ಬ ತ ್ ತ ೊ ಂ ಬ ತ ್ ತ ು |
ತೊಡಗು	ತ ೊ ಡ ಗ ು |
ತೊಡೆ	ತ ೊ ಡ ೆ |
ತೋಟದಿಂದ	ತ ೋ ಟ ದ ಿ ಂ ದ |
ತೋಟವನ್ನು	ತ ೋ ಟ ವ ನ ್ ನ ು |
ತೋರಿಸು	ತ ೋ ರ ಿ ಸ ು |
ತೋಳು	ತ ೋ ಳ ು |
ತ್ಯಾಗ	ತ ್ ಯ ಾ ಗ |
ತ್ಯಾಗದಿಂದ	ತ ್ ಯ ಾ ಗ ದ ಿ ಂ ದ |
ತ್ರಿಚೂರ್	ತ ್ ರ ಿ ಚ ೂ ರ ್ |
ತ್ರಿಪಾಟಿ	ತ ್ ರ ಿ ಪ ಾ ಟ ಿ |
ತ್ರಿಬುವನ	ತ ್ ರ ಿ ಬ ು ವ ನ |
ತ್ರಿವೆನ್ಡ್ರಮ್	ತ ್ ರ ಿ ವ ೆ ನ ್ ಡ ್ ರ ಮ ್ |
ತ್ರಿವೇಣಿ	ತ ್ ರ ಿ ವ ೇ ಣ ಿ |
ಥೇಟು	ಥ ೇ ಟ ು |
ದ	ದ |
ದಂತ	ದ ಂ ತ |
ದಕ್ಷಿಣ	ದ ಕ ್ ಷ ಿ ಣ |
ದಗ್ಗಾ	ದ ಗ ್ ಗ ಾ |
ದಡ	ದ ಡ |
ದಡದಲ್ಲಿ	ದ ಡ ದ ಲ ್ ಲ ಿ |
ದಡ್ಡ	ದ ಡ ್ ಡ |
ದತ್ತ್	ದ ತ ್ ತ ್ |
ದನಗಳಿಂದ	ದ ನ ಗ ಳ ಿ ಂ ದ |
ದಪ್ಪ	ದ ಪ ್ ಪ |
ದಯಾಲ್	ದ ಯ ಾ ಲ ್ |
ದಯೆ	ದ ಯ ೆ |
ದರ್	ದ ರ ್ |
ದರ್ಶನ	ದ ರ ್ ಶ ನ |
ದಲಿತ	ದ ಲ ಿ ತ |
ದಲೇರ್	ದ ಲ ೇ ರ ್ |
ದಳ	ದ ಳ |
ದವಡೆ	ದ ವ ಡ ೆ |
ದವಡೆಮೂಳೆ	ದ ವ ಡ ೆ ಮ ೂ ಳ ೆ |
ದಶಕ	ದ ಶ ಕ |
ದಾಖಲು	ದ ಾ ಖ ಲ ು |
ದಾಖಲೆ	ದ ಾ ಖ ಲ ೆ |
ದಾಟು	ದ ಾ ಟ ು |
ದಾನಪ್ಪ	ದ ಾ ನ ಪ ್ ಪ |
ದಾಮೊಹ್	ದ ಾ ಮ ೊ ಹ ್ |
ದಾರಿ	ದ ಾ ರ ಿ |
ದಾಲ್ಮಿಯಾ	ದ ಾ ಲ ್ ಮ ಿ ಯ ಾ |
ದಾಳಿ	ದ ಾ ಳ ಿ |
ದಾವಣಗೆರೆ	ದ ಾ ವ ಣ ಗ ೆ ರ ೆ |
ದಾಸಪ್ಪ	ದ ಾ ಸ ಪ ್ ಪ |
ದಾಸ್	ದ ಾ ಸ ್ |
ದಾಸ್ರಿ	ದ ಾ ಸ ್ ರ ಿ |
ದಿಂಡಿಗಲ್	ದ ಿ ಂ ಡ ಿ ಗ ಲ ್ |
ದಿಕ್ಕು	ದ ಿ ಕ ್ ಕ ು |
ದಿನ	ದ ಿ ನ |
ದಿನಗಳಲ್ಲಿ	ದ ಿ ನ ಗ ಳ ಲ ್ ಲ ಿ |
ದಿಬ್ರೂಗಢ್	ದ ಿ ಬ ್ ರ ೂ ಗ ಢ ್ |
ದಿಮಾಪುರ್	ದ ಿ ಮ ಾ ಪ ು ರ ್ |
ದಿಲೀಪ್	ದ ಿ ಲ ೀ ಪ ್ |
ದಿಲೋನ್	ದ ಿ ಲ ೋ ನ ್ |
ದೀಪ	ದ ೀ ಪ |
ದೀಪಿಕಾ	ದ ೀ ಪ ಿ ಕ ಾ |
ದೀರ್ಘ	ದ ೀ ರ ್ ಘ |
ದುಃಖ	ದ ು ಃ ಖ |
ದುಡಿ	ದ ು ಡ ಿ |
ದುಮ್ಕಾ	ದ ು ಮ ್ ಕ ಾ |
ದುರಂತ	ದ ು ರ ಂ ತ |
ದುರ್ಗಾಪುರ್	ದ ು ರ ್ ಗ ಾ ಪ ು ರ ್ |
ದುರ್ಗ್	ದ ು ರ ್ ಗ ್ |
ದೂರ	ದ ೂ ರ |
ದೂರದ	ದ ೂ ರ ದ |
ದೂರದಲ್ಲಿ	ದ ೂ ರ ದ ಲ ್ ಲ ಿ |
ದೂರವಾಗುತ್ತಾರೆ	ದ ೂ ರ ವ ಾ ಗ ು ತ ್ ತ ಾ ರ ೆ |
ದೂರು	ದ ೂ ರ ು |
ದೃಶ್ಯ	ದ ೃ ಶ ್ ಯ |
ದೃಷ್ಟಿ	ದ ೃ ಷ ್ ಟ ಿ |
ದೆಹರಾದೂನ್	ದ ೆ ಹ ರ ಾ ದ ೂ ನ ್ |
ದೆಹಲಿ	ದ ೆ ಹ ಲ ಿ |
ದೇವ	ದ ೇ ವ |
ದೇವಗನ್	ದ ೇ ವ ಗ ನ ್ |
ದೇವಘರ್	ದ ೇ ವ ಘ ರ ್ |
ದೇವದುರ್ಗ	ದ ೇ ವ ದ ು ರ ್ ಗ |
ದೇವನಹಳ್ಳಿ	ದ ೇ ವ ನ ಹ ಳ ್ ಳ ಿ |
ದೇವರಾಜ	ದ ೇ ವ ರ ಾ ಜ |
ದೇವರಾಜ್	ದ ೇ ವ ರ ಾ ಜ ್ |
ದೇವರಿಯ	ದ ೇ ವ ರ ಿ ಯ |
ದೇವರು	ದ ೇ ವ ರ ು |
ದೇವಶೀಶ್	ದ ೇ ವ ಶ ೀ ಶ ್ |
ದೇವಸ್ಥಾನ	ದ ೇ ವ ಸ ್ ಥ ಾ ನ |
ದೇವಸ್ಧಾನವಿದೆ	ದ ೇ ವ ಸ ್ ಧ ಾ ನ ವ ಿ ದ ೆ |
ದೇವಾನಂದ್	ದ ೇ ವ ಾ ನ ಂ ದ ್ |
ದೇವಾಲಯ	ದ ೇ ವ ಾ ಲ ಯ |
ದೇವಿ	ದ ೇ ವ ಿ |
ದೇವಿಯ	ದ ೇ ವ ಿ ಯ |
ದೇವಿಶೆಟ್ಟಿ	ದ ೇ ವ ಿ ಶ ೆ ಟ ್ ಟ ಿ |
ದೇವುಡು	ದ ೇ ವ ು ಡ ು |
ದೇವೇಗೌಡ	ದ ೇ ವ ೇ ಗ ೌ ಡ |
ದೇವ್	ದ ೇ ವ ್ |
ದೇಶ	ದ ೇ ಶ |
ದೇಶದ	ದ ೇ ಶ ದ |
ದೇಹ	ದ ೇ ಹ |
ದೇಹಕ್ಕೆ	ದ ೇ ಹ ಕ ್ ಕ ೆ |
ದೇಹದಲ್ಲಿ	ದ ೇ ಹ ದ ಲ ್ ಲ ಿ |
ದೈಹಿಕ	ದ ೈ ಹ ಿ ಕ |
ದೊಡ್ಡ	ದ ೊ ಡ ್ ಡ |
ದೊಡ್ಡದು	ದ ೊ ಡ ್ ಡ ದ ು |
ದೊರಕು	ದ ೊ ರ ಕ ು |
ದೊರೆ	ದ ೊ ರ ೆ |
ದೊರೆಸ್ವಾಮಿ	ದ ೊ ರ ೆ ಸ ್ ವ ಾ ಮ ಿ |
ದೋಡಾ	ದ ೋ ಡ ಾ |
ದ್ರವ	ದ ್ ರ ವ |
ದ್ರಾವಿಡ್	ದ ್ ರ ಾ ವ ಿ ಡ ್ |
ದ್ವಾರ	ದ ್ ವ ಾ ರ |
ದ್ವಿತೀಯ	ದ ್ ವ ಿ ತ ೀ ಯ |
ದ್ವಿವೇದಿ	ದ ್ ವ ಿ ವ ೇ ದ ಿ |
ಧನಸ್ಸು	ಧ ನ ಸ ್ ಸ ು |
ಧನ್ಬಾದ್	ಧ ನ ್ ಬ ಾ ದ ್ |
ಧರಿಸಬೇಕು	ಧ ರ ಿ ಸ ಬ ೇ ಕ ು |
ಧರಿಸು	ಧ ರ ಿ ಸ ು |
ಧರ್ಮ	ಧ ರ ್ ಮ |
ಧರ್ಮಶಾಲಾ	ಧ ರ ್ ಮ ಶ ಾ ಲ ಾ |
ಧರ್ಮಸ್ಥಳ	ಧ ರ ್ ಮ ಸ ್ ಥ ಳ |
ಧರ್ಮೇಂದ್ರ	ಧ ರ ್ ಮ ೇ ಂ ದ ್ ರ |
ಧಾರವಾಡ	ಧ ಾ ರ ವ ಾ ಡ |
ಧಾರಾಕಾರವಾಗಿ	ಧ ಾ ರ ಾ ಕ ಾ ರ ವ ಾ ಗ ಿ |
ಧಾರ್ಮಿಕ	ಧ ಾ ರ ್ ಮ ಿ ಕ |
ಧೈರ್ಯ	ಧ ೈ ರ ್ ಯ |
ಧೋರಣೆ	ಧ ೋ ರ ಣ ೆ |
ಧ್ವನಿ	ಧ ್ ವ ನ ಿ |
ನ	ನ |
ನಂಜನಗೂಡು	ನ ಂ ಜ ನ ಗ ೂ ಡ ು |
ನಂಜುಂಡ	ನ ಂ ಜ ು ಂ ಡ |
ನಂತರ	ನ ಂ ತ ರ |
ನಂದಕರ್ಣಿ	ನ ಂ ದ ಕ ರ ್ ಣ ಿ |
ನಂದನ್	ನ ಂ ದ ನ ್ |
ನಂದೆಡ್	ನ ಂ ದ ೆ ಡ ್ |
ನಂಬಬೇಡ	ನ ಂ ಬ ಬ ೇ ಡ |
ನಂಬಿಕೆ	ನ ಂ ಬ ಿ ಕ ೆ |
ನಂಬು	ನ ಂ ಬ ು |
ನಕ್ಷತ್ರ	ನ ಕ ್ ಷ ತ ್ ರ |
ನಗರ	ನ ಗ ರ |
ನಗರ್	ನ ಗ ರ ್ |
ನಗು	ನ ಗ ು |
ನಗುವಿನಹಳ್ಳಿ	ನ ಗ ು ವ ಿ ನ ಹ ಳ ್ ಳ ಿ |
ನಝಿಬಾಬಾದ್	ನ ಝ ಿ ಬ ಾ ಬ ಾ ದ ್ |
ನಡಿ	ನ ಡ ಿ |
ನಡೀರಿ	ನ ಡ ೀ ರ ಿ |
ನಡು	ನ ಡ ು |
ನಡುವಣ	ನ ಡ ು ವ ಣ |
ನಡುವೆ	ನ ಡ ು ವ ೆ |
ನಡೆ	ನ ಡ ೆ |
ನಡೆಯಬೇಡ	ನ ಡ ೆ ಯ ಬ ೇ ಡ |
ನಡೆಯಬೇಡಿ	ನ ಡ ೆ ಯ ಬ ೇ ಡ ಿ |
ನಡೆಸು	ನ ಡ ೆ ಸ ು |
ನದಿ	ನ ದ ಿ |
ನನಗೆ	ನ ನ ಗ ೆ |
ನನ್ನ	ನ ನ ್ ನ |
ನನ್ನದು	ನ ನ ್ ನ ದ ು |
ನಮಃ	ನ ಮ ಃ |
ನಮಗೆ	ನ ಮ ಗ ೆ |
ನಮ್ಮ	ನ ಮ ್ ಮ |
ನಯ	ನ ಯ |
ನಯನ್	ನ ಯ ನ ್ |
ನರಗುಂದ	ನ ರ ಗ ು ಂ ದ |
ನರಸೀಪುರ	ನ ರ ಸ ೀ ಪ ು ರ |
ನರಿ	ನ ರ ಿ |
ನರೇಂದ್ರ್	ನ ರ ೇ ಂ ದ ್ ರ ್ |
ನರ್ಕಟಿಯಾಗಂಜ್	ನ ರ ್ ಕ ಟ ಿ ಯ ಾ ಗ ಂ ಜ ್ |
ನರ್ವರ್	ನ ರ ್ ವ ರ ್ |
ನಲವತ್ತಮೂರು	ನ ಲ ವ ತ ್ ತ ಮ ೂ ರ ು |
ನಲವತ್ತಾರು	ನ ಲ ವ ತ ್ ತ ಾ ರ ು |
ನಲವತ್ತು	ನ ಲ ವ ತ ್ ತ ು |
ನಲವತ್ತೆಂಟು	ನ ಲ ವ ತ ್ ತ ೆ ಂ ಟ ು |
ನಲವತ್ತೆರಡು	ನ ಲ ವ ತ ್ ತ ೆ ರ ಡ ು |
ನಲವತ್ತೇಳು	ನ ಲ ವ ತ ್ ತ ೇ ಳ ು |
ನಲವತ್ತೈದು	ನ ಲ ವ ತ ್ ತ ೈ ದ ು |
ನಲವತ್ತೊಂದು	ನ ಲ ವ ತ ್ ತ ೊ ಂ ದ ು |
ನಲವತ್ತೊಂಬತ್ತು	ನ ಲ ವ ತ ್ ತ ೊ ಂ ಬ ತ ್ ತ ು |
ನಲವತ್ತ್ನಾಲ್ಕು	ನ ಲ ವ ತ ್ ತ ್ ನ ಾ ಲ ್ ಕ ು |
ನಲ್ಗೊಂಡಾ	ನ ಲ ್ ಗ ೊ ಂ ಡ ಾ |
ನಲ್ಲಿ	ನ ಲ ್ ಲ ಿ |
ನಳಿನಿ	ನ ಳ ಿ ನ ಿ |
ನವ	ನ ವ |
ನವಂಬರ್	ನ ವ ಂ ಬ ರ ್ |
ನವಜೋತ್	ನ ವ ಜ ೋ ತ ್ |
ನವಲಗುಂದ	ನ ವ ಲ ಗ ು ಂ ದ |
ನವಾಜ್	ನ ವ ಾ ಜ ್ |
ನವಿಲು	ನ ವ ಿ ಲ ು |
ನವೀನ್	ನ ವ ೀ ನ ್ |
ನಶಿಸಿ	ನ ಶ ಿ ಸ ಿ |
ನಷ್ಟ	ನ ಷ ್ ಟ |
ನಾಗಚಂದ್ರ	ನ ಾ ಗ ಚ ಂ ದ ್ ರ |
ನಾಗತಿಹಳ್ಳಿ	ನ ಾ ಗ ತ ಿ ಹ ಳ ್ ಳ ಿ |
ನಾಗನಹಳ್ಳಿ	ನ ಾ ಗ ನ ಹ ಳ ್ ಳ ಿ |
ನಾಗಮಂಗಲ	ನ ಾ ಗ ಮ ಂ ಗ ಲ |
ನಾಗರಹೊಳೆ	ನ ಾ ಗ ರ ಹ ೊ ಳ ೆ |
ನಾಗರಾಜ್	ನ ಾ ಗ ರ ಾ ಜ ್ |
ನಾಗರಿಕ	ನ ಾ ಗ ರ ಿ ಕ |
ನಾಗರ್	ನ ಾ ಗ ರ ್ |
ನಾಗವರ್ಮ	ನ ಾ ಗ ವ ರ ್ ಮ |
ನಾಗಾಭರಣ	ನ ಾ ಗ ಾ ಭ ರ ಣ |
ನಾಗೇಶ್ವರ	ನ ಾ ಗ ೇ ಶ ್ ವ ರ |
ನಾಗ್	ನ ಾ ಗ ್ |
ನಾಚಪ್ಪ	ನ ಾ ಚ ಪ ್ ಪ |
ನಾಟಕ	ನ ಾ ಟ ಕ |
ನಾಡಿಮಿಡಿತ	ನ ಾ ಡ ಿ ಮ ಿ ಡ ಿ ತ |
ನಾಡು	ನ ಾ ಡ ು |
ನಾಥ್	ನ ಾ ಥ ್ |
ನಾದಿನಿ	ನ ಾ ದ ಿ ನ ಿ |
ನಾನಾ	ನ ಾ ನ ಾ |
ನಾನು	ನ ಾ ನ ು |
ನಾನೂರು	ನ ಾ ನ ೂ ರ ು |
ನಾಯಕ	ನ ಾ ಯ ಕ |
ನಾಯಕತ್ವ	ನ ಾ ಯ ಕ ತ ್ ವ |
ನಾಯಿ	ನ ಾ ಯ ಿ |
ನಾಯುಡು	ನ ಾ ಯ ು ಡ ು |
ನಾರಾಯಣ	ನ ಾ ರ ಾ ಯ ಣ |
ನಾರಾಯಣಮೂರ್ತಿ	ನ ಾ ರ ಾ ಯ ಣ ಮ ೂ ರ ್ ತ ಿ |
ನಾರಾಯಣರಾವ್	ನ ಾ ರ ಾ ಯ ಣ ರ ಾ ವ ್ |
ನಾರಾಯಣ್	ನ ಾ ರ ಾ ಯ ಣ ್ |
ನಾಲಿಗೆ	ನ ಾ ಲ ಿ ಗ ೆ |
ನಾಲ್ಕನೆಯ	ನ ಾ ಲ ್ ಕ ನ ೆ ಯ |
ನಾಲ್ಕು	ನ ಾ ಲ ್ ಕ ು |
ನಾಲ್ವಡಿ	ನ ಾ ಲ ್ ವ ಡ ಿ |
ನಾಳೆ	ನ ಾ ಳ ೆ |
ನಾವು	ನ ಾ ವ ು |
ನಾಶ	ನ ಾ ಶ |
ನಾಸಿಕ	ನ ಾ ಸ ಿ ಕ |
ನಾಸಿಕ್	ನ ಾ ಸ ಿ ಕ ್ |
ನಿಂತು	ನ ಿ ಂ ತ ು |
ನಿಖಿಲ್	ನ ಿ ಖ ಿ ಲ ್ |
ನಿಗಮ್	ನ ಿ ಗ ಮ ್ |
ನಿಜ	ನ ಿ ಜ |
ನಿಜಲಿಂಗಪ್ಪ	ನ ಿ ಜ ಲ ಿ ಂ ಗ ಪ ್ ಪ |
ನಿಟ್ಟು	ನ ಿ ಟ ್ ಟ ು |
ನಿತ್ಯ	ನ ಿ ತ ್ ಯ |
ನಿದರ್ಶನ	ನ ಿ ದ ರ ್ ಶ ನ |
ನಿದ್ದೆ	ನ ಿ ದ ್ ದ ೆ |
ನಿದ್ರೆ	ನ ಿ ದ ್ ರ ೆ |
ನಿದ್ರೆಯಲ್ಲಿ	ನ ಿ ದ ್ ರ ೆ ಯ ಲ ್ ಲ ಿ |
ನಿಧಾನ	ನ ಿ ಧ ಾ ನ |
ನಿನಗೆ	ನ ಿ ನ ಗ ೆ |
ನಿನ್ನ	ನ ಿ ನ ್ ನ |
ನಿನ್ನನ್ನು	ನ ಿ ನ ್ ನ ನ ್ ನ ು |
ನಿನ್ನೆ	ನ ಿ ನ ್ ನ ೆ |
ನಿಮಿಷ	ನ ಿ ಮ ಿ ಷ |
ನಿಮ್ಮ	ನ ಿ ಮ ್ ಮ |
ನಿಯಂತ್ರಣ	ನ ಿ ಯ ಂ ತ ್ ರ ಣ |
ನಿಯಮ	ನ ಿ ಯ ಮ |
ನಿರಂತರ	ನ ಿ ರ ಂ ತ ರ |
ನಿರಾಕರಿಸು	ನ ಿ ರ ಾ ಕ ರ ಿ ಸ ು |
ನಿರಾಲಾ	ನ ಿ ರ ಾ ಲ ಾ |
ನಿರೀಕ್ಷೆ	ನ ಿ ರ ೀ ಕ ್ ಷ ೆ |
ನಿರೂಪಣೆ	ನ ಿ ರ ೂ ಪ ಣ ೆ |
ನಿರ್ಣಯ	ನ ಿ ರ ್ ಣ ಯ |
ನಿರ್ಣಾಯಕ	ನ ಿ ರ ್ ಣ ಾ ಯ ಕ |
ನಿರ್ದಿಷ್ಟ	ನ ಿ ರ ್ ದ ಿ ಷ ್ ಟ |
ನಿರ್ದೇಶಕ	ನ ಿ ರ ್ ದ ೇ ಶ ಕ |
ನಿರ್ಧರಿಸು	ನ ಿ ರ ್ ಧ ರ ಿ ಸ ು |
ನಿರ್ಧಾರ	ನ ಿ ರ ್ ಧ ಾ ರ |
ನಿರ್ಧಾರಕ್ಕೆ	ನ ಿ ರ ್ ಧ ಾ ರ ಕ ್ ಕ ೆ |
ನಿರ್ಮಾಣ	ನ ಿ ರ ್ ಮ ಾ ಣ |
ನಿರ್ವಹಣೆ	ನ ಿ ರ ್ ವ ಹ ಣ ೆ |
ನಿಲುವು	ನ ಿ ಲ ು ವ ು |
ನಿಲ್ಲಿಸಬೇಡ	ನ ಿ ಲ ್ ಲ ಿ ಸ ಬ ೇ ಡ |
ನಿಲ್ಲಿಸಿ	ನ ಿ ಲ ್ ಲ ಿ ಸ ಿ |
ನಿಲ್ಲಿಸು	ನ ಿ ಲ ್ ಲ ಿ ಸ ು |
ನಿಲ್ಲು	ನ ಿ ಲ ್ ಲ ು |
ನಿಶಾ	ನ ಿ ಶ ಾ |
ನಿಷೇಧ	ನ ಿ ಷ ೇ ಧ |
ನಿಸರ್ಗ	ನ ಿ ಸ ರ ್ ಗ |
ನಿಸಾರ್	ನ ಿ ಸ ಾ ರ ್ |
ನೀಡು	ನ ೀ ಡ ು |
ನೀತಿ	ನ ೀ ತ ಿ |
ನೀನು	ನ ೀ ನ ು |
ನೀರನ್ನು	ನ ೀ ರ ನ ್ ನ ು |
ನೀರಿನಲ್ಲಿ	ನ ೀ ರ ಿ ನ ಲ ್ ಲ ಿ |
ನೀರು	ನ ೀ ರ ು |
ನೀಲಂ	ನ ೀ ಲ ಂ |
ನೀಲಿ	ನ ೀ ಲ ಿ |
ನೀಲೇಕಣಿ	ನ ೀ ಲ ೇ ಕ ಣ ಿ |
ನೀಲೇಶ್	ನ ೀ ಲ ೇ ಶ ್ |
ನೀವು	ನ ೀ ವ ು |
ನುಂಗು	ನ ು ಂ ಗ ು |
ನುಡಿ	ನ ು ಡ ಿ |
ನುಡಿಯವರನ್ನು	ನ ು ಡ ಿ ಯ ವ ರ ನ ್ ನ ು |
ನೂತನ	ನ ೂ ತ ನ |
ನೂರು	ನ ೂ ರ ು |
ನೆಂಟರು	ನ ೆ ಂ ಟ ರ ು |
ನೆಕ್ಕು	ನ ೆ ಕ ್ ಕ ು |
ನೆನಪು	ನ ೆ ನ ಪ ು |
ನೆಪ್ಚುನ್	ನ ೆ ಪ ್ ಚ ು ನ ್ |
ನೆರವು	ನ ೆ ರ ವ ು |
ನೆರೆ	ನ ೆ ರ ೆ |
ನೆಲ	ನ ೆ ಲ |
ನೆಲಮಂಗಲ	ನ ೆ ಲ ಮ ಂ ಗ ಲ |
ನೆಲೆ	ನ ೆ ಲ ೆ |
ನೆಲ್ಲುರ್	ನ ೆ ಲ ್ ಲ ು ರ ್ |
ನೆಹರು	ನ ೆ ಹ ರ ು |
ನೇತೃತ್ವ	ನ ೇ ತ ೃ ತ ್ ವ |
ನೇತ್ರಾವಲಿ	ನ ೇ ತ ್ ರ ಾ ವ ಲ ಿ |
ನೇಮಕ	ನ ೇ ಮ ಕ |
ನೇರ	ನ ೇ ರ |
ನೇರಳೆ	ನ ೇ ರ ಳ ೆ |
ನೈತಿಕ	ನ ೈ ತ ಿ ಕ |
ನೈನಿತಾಲ್	ನ ೈ ನ ಿ ತ ಾ ಲ ್ |
ನೈರುತ್ಯ	ನ ೈ ರ ು ತ ್ ಯ |
ನೊಗ	ನ ೊ ಗ |
ನೊಣ	ನ ೊ ಣ |
ನೊಯ್ಡಾ	ನ ೊ ಯ ್ ಡ ಾ |
ನೊರೆ	ನ ೊ ರ ೆ |
ನೋಡಬೇಡ	ನ ೋ ಡ ಬ ೇ ಡ |
ನೋಡಲು	ನ ೋ ಡ ಲ ು |
ನೋಡಿ	ನ ೋ ಡ ಿ |
ನೋಡು	ನ ೋ ಡ ು |
ನೋವು	ನ ೋ ವ ು |
ನೌ	ನ ೌ |
ನೌಕರ	ನ ೌ ಕ ರ |
ನೌಗಾಂವ್	ನ ೌ ಗ ಾ ಂ ವ ್ |
ನ್ಯಾಯ	ನ ್ ಯ ಾ ಯ |
ನ್ಯಾಯಾಲಯ	ನ ್ ಯ ಾ ಯ ಾ ಲ ಯ |
ಪಂಕಜ್	ಪ ಂ ಕ ಜ ್ |
ಪಂಚಾಯಿತಿ	ಪ ಂ ಚ ಾ ಯ ಿ ತ ಿ |
ಪಂಚೆ	ಪ ಂ ಚ ೆ |
ಪಂಜಾಬಿನಲ್ಲಿ	ಪ ಂ ಜ ಾ ಬ ಿ ನ ಲ ್ ಲ ಿ |
ಪಂಡರಾಪುರ	ಪ ಂ ಡ ರ ಾ ಪ ು ರ |
ಪಂಡಿತ	ಪ ಂ ಡ ಿ ತ |
ಪಂಡಿತ್	ಪ ಂ ಡ ಿ ತ ್ |
ಪಂತ್	ಪ ಂ ತ ್ |
ಪಂದ್ಯ	ಪ ಂ ದ ್ ಯ |
ಪಂದ್ಯಶ್ರೇಷ್ಠ	ಪ ಂ ದ ್ ಯ ಶ ್ ರ ೇ ಷ ್ ಠ |
ಪಂದ್ಯಾವಳಿ	ಪ ಂ ದ ್ ಯ ಾ ವ ಳ ಿ |
ಪಂಪ	ಪ ಂ ಪ |
ಪಕ್ಕ	ಪ ಕ ್ ಕ |
ಪಕ್ಕದ	ಪ ಕ ್ ಕ ದ |
ಪಕ್ಕದಲ್ಲಿ	ಪ ಕ ್ ಕ ದ ಲ ್ ಲ ಿ |
ಪಕ್ಕವಾದ್ಯಗಳ	ಪ ಕ ್ ಕ ವ ಾ ದ ್ ಯ ಗ ಳ |
ಪಕ್ಕೆಲುಬು	ಪ ಕ ್ ಕ ೆ ಲ ು ಬ ು |
ಪಕ್ಷ	ಪ ಕ ್ ಷ |
ಪಟೀಲ್	ಪ ಟ ೀ ಲ ್ |
ಪಟೇಲ್	ಪ ಟ ೇ ಲ ್ |
ಪಟ್ಟ	ಪ ಟ ್ ಟ |
ಪಟ್ಟಣ	ಪ ಟ ್ ಟ ಣ |
ಪಟ್ಟಾಭಿ	ಪ ಟ ್ ಟ ಾ ಭ ಿ |
ಪಟ್ಟಿ	ಪ ಟ ್ ಟ ಿ |
ಪಟ್ನಾ	ಪ ಟ ್ ನ ಾ |
ಪಡಿಸು	ಪ ಡ ಿ ಸ ು |
ಪಡುಕೋಣೆ	ಪ ಡ ು ಕ ೋ ಣ ೆ |
ಪಡೆ	ಪ ಡ ೆ |
ಪಡೆದ	ಪ ಡ ೆ ದ |
ಪಡೆದಿದ್ದಾಳೆ	ಪ ಡ ೆ ದ ಿ ದ ್ ದ ಾ ಳ ೆ |
ಪಡೆದು	ಪ ಡ ೆ ದ ು |
ಪಡೆಯಲು	ಪ ಡ ೆ ಯ ಲ ು |
ಪಣಜೀ	ಪ ಣ ಜ ೀ |
ಪತನ	ಪ ತ ನ |
ಪತಿ	ಪ ತ ಿ |
ಪತ್ನಾಗರ್	ಪ ತ ್ ನ ಾ ಗ ರ ್ |
ಪತ್ನಿ	ಪ ತ ್ ನ ಿ |
ಪತ್ರ	ಪ ತ ್ ರ |
ಪತ್ರಕರ್ತ	ಪ ತ ್ ರ ಕ ರ ್ ತ |
ಪತ್ರಿಕಾಗೋಷ್ಠಿ	ಪ ತ ್ ರ ಿ ಕ ಾ ಗ ೋ ಷ ್ ಠ ಿ |
ಪತ್ರಿಕೆ	ಪ ತ ್ ರ ಿ ಕ ೆ |
ಪಥಾಕೋಟ್	ಪ ಥ ಾ ಕ ೋ ಟ ್ |
ಪದ	ಪ ದ |
ಪದಕ	ಪ ದ ಕ |
ಪದವಿ	ಪ ದ ವ ಿ |
ಪದೇ	ಪ ದ ೇ |
ಪದ್ಧತಿ	ಪ ದ ್ ಧ ತ ಿ |
ಪದ್ಮನಾಭ	ಪ ದ ್ ಮ ನ ಾ ಭ |
ಪದ್ಯ	ಪ ದ ್ ಯ |
ಪರ	ಪ ರ |
ಪರಂಪರೆ	ಪ ರ ಂ ಪ ರ ೆ |
ಪರಸ್ಪರ	ಪ ರ ಸ ್ ಪ ರ |
ಪರಿಗಣಿಸು	ಪ ರ ಿ ಗ ಣ ಿ ಸ ು |
ಪರಿಚಯ	ಪ ರ ಿ ಚ ಯ |
ಪರಿಣಾಮ	ಪ ರ ಿ ಣ ಾ ಮ |
ಪರಿಣಾಮಕಾರಿ	ಪ ರ ಿ ಣ ಾ ಮ ಕ ಾ ರ ಿ |
ಪರಿವರ್ತನೆ	ಪ ರ ಿ ವ ರ ್ ತ ನ ೆ |
ಪರಿಶಿಷ್ಟ	ಪ ರ ಿ ಶ ಿ ಷ ್ ಟ |
ಪರಿಶೀಲನೆ	ಪ ರ ಿ ಶ ೀ ಲ ನ ೆ |
ಪರಿಷತ್ತು	ಪ ರ ಿ ಷ ತ ್ ತ ು |
ಪರಿಸರ	ಪ ರ ಿ ಸ ರ |
ಪರಿಸ್ಥಿತಿ	ಪ ರ ಿ ಸ ್ ಥ ಿ ತ ಿ |
ಪರಿಹಾರ	ಪ ರ ಿ ಹ ಾ ರ |
ಪರೀಕ್ಷೆ	ಪ ರ ೀ ಕ ್ ಷ ೆ |
ಪರೀಕ್ಷೆಯಲ್ಲಿ	ಪ ರ ೀ ಕ ್ ಷ ೆ ಯ ಲ ್ ಲ ಿ |
ಪರೇಶ್	ಪ ರ ೇ ಶ ್ |
ಪರೋಕ್ಷ	ಪ ರ ೋ ಕ ್ ಷ |
ಪರೋರೆ	ಪ ರ ೋ ರ ೆ |
ಪರ್ಯಾಯ	ಪ ರ ್ ಯ ಾ ಯ |
ಪರ್ವೇಜ್	ಪ ರ ್ ವ ೇ ಜ ್ |
ಪರ್ಸೀಸ್	ಪ ರ ್ ಸ ೀ ಸ ್ |
ಪಲಾಮು	ಪ ಲ ಾ ಮ ು |
ಪವಾಪುರಿ	ಪ ವ ಾ ಪ ು ರ ಿ |
ಪವಿತ್ರ	ಪ ವ ಿ ತ ್ ರ |
ಪಶು	ಪ ಶ ು |
ಪಶ್ಚಿಮ	ಪ ಶ ್ ಚ ಿ ಮ |
ಪಾಂಡವಪುರ	ಪ ಾ ಂ ಡ ವ ಪ ು ರ |
ಪಾಂಡಿಚೇರಿ	ಪ ಾ ಂ ಡ ಿ ಚ ೇ ರ ಿ |
ಪಾಂಡೇ	ಪ ಾ ಂ ಡ ೇ |
ಪಾಂಡೇಶ್ವರ	ಪ ಾ ಂ ಡ ೇ ಶ ್ ವ ರ |
ಪಾಟೀಲ್	ಪ ಾ ಟ ೀ ಲ ್ |
ಪಾಟೇಕರ್	ಪ ಾ ಟ ೇ ಕ ರ ್ |
ಪಾಠ	ಪ ಾ ಠ |
ಪಾತ್ರ	ಪ ಾ ತ ್ ರ |
ಪಾದ	ಪ ಾ ದ |
ಪಾಪ	ಪ ಾ ಪ |
ಪಾಯಸ	ಪ ಾ ಯ ಸ |
ಪಾಯಿಂಟಿಂಗ್	ಪ ಾ ಯ ಿ ಂ ಟ ಿ ಂ ಗ ್ |
ಪಾಯ್	ಪ ಾ ಯ ್ |
ಪಾರ	ಪ ಾ ರ |
ಪಾಲು	ಪ ಾ ಲ ು |
ಪಾಳ್ಯ	ಪ ಾ ಳ ್ ಯ |
ಪಾವಗಡ	ಪ ಾ ವ ಗ ಡ |
ಪಾಶ್ಚಾತ್ಯ	ಪ ಾ ಶ ್ ಚ ಾ ತ ್ ಯ |
ಪಿ	ಪ ಿ |
ಪಿನ್ಜೌರ್	ಪ ಿ ನ ್ ಜ ೌ ರ ್ |
ಪಿನ್ಪರಿ	ಪ ಿ ನ ್ ಪ ರ ಿ |
ಪಿರಿಯಾಪಟ್ಟಣ	ಪ ಿ ರ ಿ ಯ ಾ ಪ ಟ ್ ಟ ಣ |
ಪೀಥೌರಾಘಡ್	ಪ ೀ ಥ ೌ ರ ಾ ಘ ಡ ್ |
ಪೀಪಲಿ	ಪ ೀ ಪ ಲ ಿ |
ಪೀಲಾನಿ	ಪ ೀ ಲ ಾ ನ ಿ |
ಪೀಲಿಭಿತ್	ಪ ೀ ಲ ಿ ಭ ಿ ತ ್ |
ಪುಟ	ಪ ು ಟ |
ಪುಟದಲ್ಲಿ	ಪ ು ಟ ದ ಲ ್ ಲ ಿ |
ಪುಟ್ಟ	ಪ ು ಟ ್ ಟ |
ಪುಟ್ಟಣ್ಣ	ಪ ು ಟ ್ ಟ ಣ ್ ಣ |
ಪುಟ್ಟಪ್ಪ	ಪ ು ಟ ್ ಟ ಪ ್ ಪ |
ಪುತ್ತೂರು	ಪ ು ತ ್ ತ ೂ ರ ು |
ಪುತ್ರ	ಪ ು ತ ್ ರ |
ಪುನಃ	ಪ ು ನ ಃ |
ಪುನೀತ್	ಪ ು ನ ೀ ತ ್ |
ಪುರ	ಪ ು ರ |
ಪುರಂದರದಾಸ	ಪ ು ರ ಂ ದ ರ ದ ಾ ಸ |
ಪುರಾಣ	ಪ ು ರ ಾ ಣ |
ಪುರಿ	ಪ ು ರ ಿ |
ಪುರುಲಿಯಾ	ಪ ು ರ ು ಲ ಿ ಯ ಾ |
ಪುರುಷ	ಪ ು ರ ು ಷ |
ಪುರುಷೋತ್ತಂ	ಪ ು ರ ು ಷ ೋ ತ ್ ತ ಂ |
ಪುರ್	ಪ ು ರ ್ |
ಪುಲಕೇಶಿ	ಪ ು ಲ ಕ ೇ ಶ ಿ |
ಪುಶ್ಯ	ಪ ು ಶ ್ ಯ |
ಪುಸ್ತಕ	ಪ ು ಸ ್ ತ ಕ |
ಪುಸ್ತಕದ	ಪ ು ಸ ್ ತ ಕ ದ |
ಪೂಜಾಗಾಂಧಿ	ಪ ೂ ಜ ಾ ಗ ಾ ಂ ಧ ಿ |
ಪೂಜೆ	ಪ ೂ ಜ ೆ |
ಪೂನಾ	ಪ ೂ ನ ಾ |
ಪೂರಕ	ಪ ೂ ರ ಕ |
ಪೂರಿ	ಪ ೂ ರ ಿ |
ಪೂರ್ಣ	ಪ ೂ ರ ್ ಣ |
ಪೂರ್ಣವಾಗಿ	ಪ ೂ ರ ್ ಣ ವ ಾ ಗ ಿ |
ಪೂರ್ಣಿಯಾ	ಪ ೂ ರ ್ ಣ ಿ ಯ ಾ |
ಪೂರ್ತಿ	ಪ ೂ ರ ್ ತ ಿ |
ಪೂರ್ವ	ಪ ೂ ರ ್ ವ |
ಪೆಟ್ಟಿಗೆ	ಪ ೆ ಟ ್ ಟ ಿ ಗ ೆ |
ಪೇಟೆ	ಪ ೇ ಟ ೆ |
ಪೈಕಿ	ಪ ೈ ಕ ಿ |
ಪೈರು	ಪ ೈ ರ ು |
ಪೊಂಗ್	ಪ ೊ ಂ ಗ ್ |
ಪೊರ್ಟ್	ಪ ೊ ರ ್ ಟ ್ |
ಪೌನು	ಪ ೌ ನ ು |
ಪ್ರಕಟ	ಪ ್ ರ ಕ ಟ |
ಪ್ರಕಟಿಸು	ಪ ್ ರ ಕ ಟ ಿ ಸ ು |
ಪ್ರಕರಣ	ಪ ್ ರ ಕ ರ ಣ |
ಪ್ರಕಾರ	ಪ ್ ರ ಕ ಾ ರ |
ಪ್ರಕಾಶಮ್	ಪ ್ ರ ಕ ಾ ಶ ಮ ್ |
ಪ್ರಕಾಶ್	ಪ ್ ರ ಕ ಾ ಶ ್ |
ಪ್ರಕೃತಿ	ಪ ್ ರ ಕ ೃ ತ ಿ |
ಪ್ರಕ್ರಿಯೆ	ಪ ್ ರ ಕ ್ ರ ಿ ಯ ೆ |
ಪ್ರಗತಿ	ಪ ್ ರ ಗ ತ ಿ |
ಪ್ರಗತಿಪರ	ಪ ್ ರ ಗ ತ ಿ ಪ ರ |
ಪ್ರಚಾರ	ಪ ್ ರ ಚ ಾ ರ |
ಪ್ರಜ್ಞೆ	ಪ ್ ರ ಜ ್ ಞ ೆ |
ಪ್ರತಾಪ್	ಪ ್ ರ ತ ಾ ಪ ್ |
ಪ್ರತಿ	ಪ ್ ರ ತ ಿ |
ಪ್ರತಿಕ್ರಿಯೆ	ಪ ್ ರ ತ ಿ ಕ ್ ರ ಿ ಯ ೆ |
ಪ್ರತಿದಿನ	ಪ ್ ರ ತ ಿ ದ ಿ ನ |
ಪ್ರತಿದಿನವೂ	ಪ ್ ರ ತ ಿ ದ ಿ ನ ವ ೂ |
ಪ್ರತಿನಿಧಿ	ಪ ್ ರ ತ ಿ ನ ಿ ಧ ಿ |
ಪ್ರತಿಪಕ್ಷ	ಪ ್ ರ ತ ಿ ಪ ಕ ್ ಷ |
ಪ್ರತಿಪಾದಿಸು	ಪ ್ ರ ತ ಿ ಪ ಾ ದ ಿ ಸ ು |
ಪ್ರತಿಭಟನೆ	ಪ ್ ರ ತ ಿ ಭ ಟ ನ ೆ |
ಪ್ರತಿಭಾ	ಪ ್ ರ ತ ಿ ಭ ಾ |
ಪ್ರತಿಭೆ	ಪ ್ ರ ತ ಿ ಭ ೆ |
ಪ್ರತ್ಯೇಕ	ಪ ್ ರ ತ ್ ಯ ೇ ಕ |
ಪ್ರಥಮ	ಪ ್ ರ ಥ ಮ |
ಪ್ರದರ್ಶನ	ಪ ್ ರ ದ ರ ್ ಶ ನ |
ಪ್ರದರ್ಶಿಸು	ಪ ್ ರ ದ ರ ್ ಶ ಿ ಸ ು |
ಪ್ರದೇಶ	ಪ ್ ರ ದ ೇ ಶ |
ಪ್ರಧಾನಿ	ಪ ್ ರ ಧ ಾ ನ ಿ |
ಪ್ರಪಂಚ	ಪ ್ ರ ಪ ಂ ಚ |
ಪ್ರಬಂಧ	ಪ ್ ರ ಬ ಂ ಧ |
ಪ್ರಬಲ	ಪ ್ ರ ಬ ಲ |
ಪ್ರಭಾಕರನ್	ಪ ್ ರ ಭ ಾ ಕ ರ ನ ್ |
ಪ್ರಭಾವ	ಪ ್ ರ ಭ ಾ ವ |
ಪ್ರಭು	ಪ ್ ರ ಭ ು |
ಪ್ರಭುದೇವ	ಪ ್ ರ ಭ ು ದ ೇ ವ |
ಪ್ರಮಾಣ	ಪ ್ ರ ಮ ಾ ಣ |
ಪ್ರಮುಖ	ಪ ್ ರ ಮ ು ಖ |
ಪ್ರಯತ್ನ	ಪ ್ ರ ಯ ತ ್ ನ |
ಪ್ರಯತ್ನದಿಂದ	ಪ ್ ರ ಯ ತ ್ ನ ದ ಿ ಂ ದ |
ಪ್ರಯತ್ನಿಸು	ಪ ್ ರ ಯ ತ ್ ನ ಿ ಸ ು |
ಪ್ರಯಾಗ	ಪ ್ ರ ಯ ಾ ಗ |
ಪ್ರಯಾಣ	ಪ ್ ರ ಯ ಾ ಣ |
ಪ್ರಯಾಣಕ್ಕೆ	ಪ ್ ರ ಯ ಾ ಣ ಕ ್ ಕ ೆ |
ಪ್ರಯೋಗ	ಪ ್ ರ ಯ ೋ ಗ |
ಪ್ರಯೋಜನ	ಪ ್ ರ ಯ ೋ ಜ ನ |
ಪ್ರವಾಸ	ಪ ್ ರ ವ ಾ ಸ |
ಪ್ರವಾಸಿ	ಪ ್ ರ ವ ಾ ಸ ಿ |
ಪ್ರವಾಹ	ಪ ್ ರ ವ ಾ ಹ |
ಪ್ರವೃತ್ತಿ	ಪ ್ ರ ವ ೃ ತ ್ ತ ಿ |
ಪ್ರವೇಶ	ಪ ್ ರ ವ ೇ ಶ |
ಪ್ರವೇಶಿಸು	ಪ ್ ರ ವ ೇ ಶ ಿ ಸ ು |
ಪ್ರಶಸ್ತಿ	ಪ ್ ರ ಶ ಸ ್ ತ ಿ |
ಪ್ರಶ್ನಿಸು	ಪ ್ ರ ಶ ್ ನ ಿ ಸ ು |
ಪ್ರಶ್ನೆ	ಪ ್ ರ ಶ ್ ನ ೆ |
ಪ್ರಸಂಗ	ಪ ್ ರ ಸ ಂ ಗ |
ಪ್ರಸನ್ನ	ಪ ್ ರ ಸ ನ ್ ನ |
ಪ್ರಸಾದ್	ಪ ್ ರ ಸ ಾ ದ ್ |
ಪ್ರಸಿದ್ಧ	ಪ ್ ರ ಸ ಿ ದ ್ ಧ |
ಪ್ರಸಿದ್ಧಿಯಾಗಿದೆ	ಪ ್ ರ ಸ ಿ ದ ್ ಧ ಿ ಯ ಾ ಗ ಿ ದ ೆ |
ಪ್ರಸ್ತಾಪ	ಪ ್ ರ ಸ ್ ತ ಾ ಪ |
ಪ್ರಸ್ತುತ	ಪ ್ ರ ಸ ್ ತ ು ತ |
ಪ್ರಾಚೀನ	ಪ ್ ರ ಾ ಚ ೀ ನ |
ಪ್ರಾಣ	ಪ ್ ರ ಾ ಣ |
ಪ್ರಾಣಿ	ಪ ್ ರ ಾ ಣ ಿ |
ಪ್ರಾಥಮಿಕ	ಪ ್ ರ ಾ ಥ ಮ ಿ ಕ |
ಪ್ರಾದೇಶಿಕ	ಪ ್ ರ ಾ ದ ೇ ಶ ಿ ಕ |
ಪ್ರಾಮಾಣಿಕ	ಪ ್ ರ ಾ ಮ ಾ ಣ ಿ ಕ |
ಪ್ರಾರಂಭ	ಪ ್ ರ ಾ ರ ಂ ಭ |
ಪ್ರಿಯಾಂಕ	ಪ ್ ರ ಿ ಯ ಾ ಂ ಕ |
ಪ್ರೀತಿ	ಪ ್ ರ ೀ ತ ಿ |
ಪ್ರೇಂ	ಪ ್ ರ ೇ ಂ |
ಪ್ರೇಕ್ಷಕ	ಪ ್ ರ ೇ ಕ ್ ಷ ಕ |
ಪ್ರೇಮ	ಪ ್ ರ ೇ ಮ |
ಪ್ರೇಮ್	ಪ ್ ರ ೇ ಮ ್ |
ಪ್ರೇಮ್ಜಿ	ಪ ್ ರ ೇ ಮ ್ ಜ ಿ |
ಪ್ರೇರಣೆ	ಪ ್ ರ ೇ ರ ಣ ೆ |
ಪ್ಲೂಟೋ	ಪ ್ ಲ ೂ ಟ ೋ |
ಫಕ್ರುದ್ದೀನ್	ಫ ಕ ್ ರ ು ದ ್ ದ ೀ ನ ್ |
ಫಜೀತಿ	ಫ ಜ ೀ ತ ಿ |
ಫತುಹಾ	ಫ ತ ು ಹ ಾ |
ಫತೇಹಗಢ್	ಫ ತ ೇ ಹ ಗ ಢ ್ |
ಫರಿದಾಬಾದ್	ಫ ರ ಿ ದ ಾ ಬ ಾ ದ ್ |
ಫರ್ನಾಂಡಿಸ್	ಫ ರ ್ ನ ಾ ಂ ಡ ಿ ಸ ್ |
ಫಲ	ಫ ಲ |
ಫಲಿತಾಂಶ	ಫ ಲ ಿ ತ ಾ ಂ ಶ |
ಫಾರುಕ್	ಫ ಾ ರ ು ಕ ್ |
ಫಾಲ್ಗುಣ	ಫ ಾ ಲ ್ ಗ ು ಣ |
ಫಿರೋಝಾಬಾದ್	ಫ ಿ ರ ೋ ಝ ಾ ಬ ಾ ದ ್ |
ಫಿರೋಝ್	ಫ ಿ ರ ೋ ಝ ್ |
ಫೂಜಿಯಾಮಾ	ಫ ೂ ಜ ಿ ಯ ಾ ಮ ಾ |
ಫೂರುಖ್	ಫ ೂ ರ ು ಖ ್ |
ಫೆಬ್ರವರಿ	ಫ ೆ ಬ ್ ರ ವ ರ ಿ |
ಫೈಝಾಬಾದ್	ಫ ೈ ಝ ಾ ಬ ಾ ದ ್ |
ಫೈಸಲಾಬಾದ್	ಫ ೈ ಸ ಲ ಾ ಬ ಾ ದ ್ |
ಫೋಟೋ	ಫ ೋ ಟ ೋ |
ಫೋನು	ಫ ೋ ನ ು |
ಫ್ಯಾನ್	ಫ ್ ಯ ಾ ನ ್ |
ಫ್ರೊ	ಫ ್ ರ ೊ |
ಫ್ಲೇಮಿಂಗ್	ಫ ್ ಲ ೇ ಮ ಿ ಂ ಗ ್ |
ಫ್ಲೇವರ್	ಫ ್ ಲ ೇ ವ ರ ್ |
ಬಂಗಾರ	ಬ ಂ ಗ ಾ ರ |
ಬಂಗಾರಪೇಟೆ	ಬ ಂ ಗ ಾ ರ ಪ ೇ ಟ ೆ |
ಬಂಗಾರು	ಬ ಂ ಗ ಾ ರ ು |
ಬಂಟ್ವಾಳ	ಬ ಂ ಟ ್ ವ ಾ ಳ |
ಬಂಡವಾಳ	ಬ ಂ ಡ ವ ಾ ಳ |
ಬಂಡಾಯ	ಬ ಂ ಡ ಾ ಯ |
ಬಂತು	ಬ ಂ ತ ು |
ಬಂದ	ಬ ಂ ದ |
ಬಂದರೆ	ಬ ಂ ದ ರ ೆ |
ಬಂದಿದೆ	ಬ ಂ ದ ಿ ದ ೆ |
ಬಂದಿದ್ದರು	ಬ ಂ ದ ಿ ದ ್ ದ ರ ು |
ಬಂದಿರಬೇಕಿತ್ತು	ಬ ಂ ದ ಿ ರ ಬ ೇ ಕ ಿ ತ ್ ತ ು |
ಬಂದು	ಬ ಂ ದ ು |
ಬಗೆ	ಬ ಗ ೆ |
ಬಗ್ಗು	ಬ ಗ ್ ಗ ು |
ಬಗ್ಗೆ	ಬ ಗ ್ ಗ ೆ |
ಬಚ್ಚನ್	ಬ ಚ ್ ಚ ನ ್ |
ಬಟ್ಟಲನ್ನು	ಬ ಟ ್ ಟ ಲ ನ ್ ನ ು |
ಬಟ್ಟೆ	ಬ ಟ ್ ಟ ೆ |
ಬಟ್ಟೆಗಳನ್ನು	ಬ ಟ ್ ಟ ೆ ಗ ಳ ನ ್ ನ ು |
ಬಟ್ಟೆಯನ್ನು	ಬ ಟ ್ ಟ ೆ ಯ ನ ್ ನ ು |
ಬಡ	ಬ ಡ |
ಬಡಗಿ	ಬ ಡ ಗ ಿ |
ಬಡತನ	ಬ ಡ ತ ನ |
ಬಡವ	ಬ ಡ ವ |
ಬಡಾಯಿ	ಬ ಡ ಾ ಯ ಿ |
ಬಡ್ಡಿ	ಬ ಡ ್ ಡ ಿ |
ಬಣ	ಬ ಣ |
ಬಣ್ಣ	ಬ ಣ ್ ಣ |
ಬದಲಾಗು	ಬ ದ ಲ ಾ ಗ ು |
ಬದಲಾವಣೆ	ಬ ದ ಲ ಾ ವ ಣ ೆ |
ಬದಲಿ	ಬ ದ ಲ ಿ |
ಬದಲು	ಬ ದ ಲ ು |
ಬದಿ	ಬ ದ ಿ |
ಬದುಕು	ಬ ದ ು ಕ ು |
ಬದುಕುತ್ತಾನೆ	ಬ ದ ು ಕ ು ತ ್ ತ ಾ ನ ೆ |
ಬನ್ನಿ	ಬ ನ ್ ನ ಿ |
ಬನ್ನೂರು	ಬ ನ ್ ನ ೂ ರ ು |
ಬಯಸು	ಬ ಯ ಸ ು |
ಬರಬಾರದು	ಬ ರ ಬ ಾ ರ ದ ು |
ಬರಬೇಡ	ಬ ರ ಬ ೇ ಡ |
ಬರಲಿಲ್ಲ	ಬ ರ ಲ ಿ ಲ ್ ಲ |
ಬರಲು	ಬ ರ ಲ ು |
ಬರವಣಿಗೆ	ಬ ರ ವ ಣ ಿ ಗ ೆ |
ಬರಹ	ಬ ರ ಹ |
ಬರಿ	ಬ ರ ಿ |
ಬರು	ಬ ರ ು |
ಬರುತ್ತದೆ	ಬ ರ ು ತ ್ ತ ದ ೆ |
ಬರುತ್ತಾರೆ	ಬ ರ ು ತ ್ ತ ಾ ರ ೆ |
ಬರುವ	ಬ ರ ು ವ |
ಬರುವಾ	ಬ ರ ು ವ ಾ |
ಬರುವುದನ್ನು	ಬ ರ ು ವ ು ದ ನ ್ ನ ು |
ಬರೆ	ಬ ರ ೆ |
ಬರೆಯಬೇಡ	ಬ ರ ೆ ಯ ಬ ೇ ಡ |
ಬರೆಯಿರಿ	ಬ ರ ೆ ಯ ಿ ರ ಿ |
ಬರೋಡಾ	ಬ ರ ೋ ಡ ಾ |
ಬರೌನಿ	ಬ ರ ೌ ನ ಿ |
ಬರ್ಧಮಾನ್	ಬ ರ ್ ಧ ಮ ಾ ನ ್ |
ಬರ್ನಾಲಾ	ಬ ರ ್ ನ ಾ ಲ ಾ |
ಬಲ	ಬ ಲ |
ಬಲರಾಮ್	ಬ ಲ ರ ಾ ಮ ್ |
ಬಲವೇಂದರ್	ಬ ಲ ವ ೇ ಂ ದ ರ ್ |
ಬಲಶಾಲಿ	ಬ ಲ ಶ ಾ ಲ ಿ |
ಬಲಶಾಲಿಯೋ	ಬ ಲ ಶ ಾ ಲ ಿ ಯ ೋ |
ಬಲಿ	ಬ ಲ ಿ |
ಬಲಿರಾಮ್	ಬ ಲ ಿ ರ ಾ ಮ ್ |
ಬಲು	ಬ ಲ ು |
ಬಳಕೆ	ಬ ಳ ಕ ೆ |
ಬಳಗ	ಬ ಳ ಗ |
ಬಳಸಲಾಗುತ್ತದೆ	ಬ ಳ ಸ ಲ ಾ ಗ ು ತ ್ ತ ದ ೆ |
ಬಳಸಿದರೆ	ಬ ಳ ಸ ಿ ದ ರ ೆ |
ಬಳಸು	ಬ ಳ ಸ ು |
ಬಳಸುತ್ತಾರೆ	ಬ ಳ ಸ ು ತ ್ ತ ಾ ರ ೆ |
ಬಳಸುತ್ತಿದ್ದರು	ಬ ಳ ಸ ು ತ ್ ತ ಿ ದ ್ ದ ರ ು |
ಬಳಸುತ್ತೇವೆ	ಬ ಳ ಸ ು ತ ್ ತ ೇ ವ ೆ |
ಬಳಿಕ	ಬ ಳ ಿ ಕ |
ಬಳಿಗೆ	ಬ ಳ ಿ ಗ ೆ |
ಬಳ್ಳಾಪುರ	ಬ ಳ ್ ಳ ಾ ಪ ು ರ |
ಬಳ್ಳಾರಿ	ಬ ಳ ್ ಳ ಾ ರ ಿ |
ಬಸಪ್ಪ	ಬ ಸ ಪ ್ ಪ |
ಬಸರಾಳು	ಬ ಸ ರ ಾ ಳ ು |
ಬಸವಕಲ್ಯಾಣ	ಬ ಸ ವ ಕ ಲ ್ ಯ ಾ ಣ |
ಬಸವಣ್ಣ	ಬ ಸ ವ ಣ ್ ಣ |
ಬಸವನ	ಬ ಸ ವ ನ |
ಬಸವಪ್ಪಶಾಸ್ತಿ	ಬ ಸ ವ ಪ ್ ಪ ಶ ಾ ಸ ್ ತ ಿ |
ಬಸವರಾಜ	ಬ ಸ ವ ರ ಾ ಜ |
ಬಸುರಿ	ಬ ಸ ು ರ ಿ |
ಬಸ್ತೀ	ಬ ಸ ್ ತ ೀ |
ಬಸ್ಸು	ಬ ಸ ್ ಸ ು |
ಬಸ್ಸುಗಳು	ಬ ಸ ್ ಸ ು ಗ ಳ ು |
ಬಹದೂರ್	ಬ ಹ ದ ೂ ರ ್ |
ಬಹಳ	ಬ ಹ ಳ |
ಬಹಾದೂರ್	ಬ ಹ ಾ ದ ೂ ರ ್ |
ಬಹಾದ್ದೂರ್	ಬ ಹ ಾ ದ ್ ದ ೂ ರ ್ |
ಬಹಿರಂಗ	ಬ ಹ ಿ ರ ಂ ಗ |
ಬಹುತುಲೇ	ಬ ಹ ು ತ ು ಲ ೇ |
ಬಹುತೇಕ	ಬ ಹ ು ತ ೇ ಕ |
ಬಹುಶಃ	ಬ ಹ ು ಶ ಃ |
ಬಾ	ಬ ಾ |
ಬಾಂಕುಡಾ	ಬ ಾ ಂ ಕ ು ಡ ಾ |
ಬಾಗಲಕೋಟೆ	ಬ ಾ ಗ ಲ ಕ ೋ ಟ ೆ |
ಬಾಗಿಲು	ಬ ಾ ಗ ಿ ಲ ು |
ಬಾಗೇಪಲ್ಲಿ	ಬ ಾ ಗ ೇ ಪ ಲ ್ ಲ ಿ |
ಬಾಗೇವಾಡಿ	ಬ ಾ ಗ ೇ ವ ಾ ಡ ಿ |
ಬಾಟ್ಲಿ	ಬ ಾ ಟ ್ ಲ ಿ |
ಬಾಡಿಗೆ	ಬ ಾ ಡ ಿ ಗ ೆ |
ಬಾಡು	ಬ ಾ ಡ ು |
ಬಾಡುತ್ತದೆ	ಬ ಾ ಡ ು ತ ್ ತ ದ ೆ |
ಬಾದಾಮಿ	ಬ ಾ ದ ಾ ಮ ಿ |
ಬಾದ್ರಪದ	ಬ ಾ ದ ್ ರ ಪ ದ |
ಬಾನ್ಸವಾಡ	ಬ ಾ ನ ್ ಸ ವ ಾ ಡ |
ಬಾಬಿ	ಬ ಾ ಬ ಿ |
ಬಾಬು	ಬ ಾ ಬ ು |
ಬಾಯಿ	ಬ ಾ ಯ ಿ |
ಬಾರಿ	ಬ ಾ ರ ಿ |
ಬಾರಿಸು	ಬ ಾ ರ ಿ ಸ ು |
ಬಾರೇ	ಬ ಾ ರ ೇ |
ಬಾರೋ	ಬ ಾ ರ ೋ |
ಬಾಲಕ	ಬ ಾ ಲ ಕ |
ಬಾಲಯೋಗಿ	ಬ ಾ ಲ ಯ ೋ ಗ ಿ |
ಬಾಲಸುಬ್ರಮಣ್ಯಂ	ಬ ಾ ಲ ಸ ು ಬ ್ ರ ಮ ಣ ್ ಯ ಂ |
ಬಾಲಾಸೋರ್	ಬ ಾ ಲ ಾ ಸ ೋ ರ ್ |
ಬಾಲ್ಕಿ	ಬ ಾ ಲ ್ ಕ ಿ |
ಬಾಳು	ಬ ಾ ಳ ು |
ಬಾವಿ	ಬ ಾ ವ ಿ |
ಬಾಸ	ಬ ಾ ಸ |
ಬಿ	ಬ ಿ |
ಬಿಂದ್ರ	ಬ ಿ ಂ ದ ್ ರ |
ಬಿಕ್ರಂ	ಬ ಿ ಕ ್ ರ ಂ |
ಬಿಜನೌರ್	ಬ ಿ ಜ ನ ೌ ರ ್ |
ಬಿಜಾಪುರ	ಬ ಿ ಜ ಾ ಪ ು ರ |
ಬಿಜಾಪುರ್	ಬ ಿ ಜ ಾ ಪ ು ರ ್ |
ಬಿಟ್ಟರೆ	ಬ ಿ ಟ ್ ಟ ರ ೆ |
ಬಿಡದಿ	ಬ ಿ ಡ ದ ಿ |
ಬಿಡು	ಬ ಿ ಡ ು |
ಬಿಡುಗಡೆ	ಬ ಿ ಡ ು ಗ ಡ ೆ |
ಬಿದ್ದ	ಬ ಿ ದ ್ ದ |
ಬಿದ್ದಿತ್ತು	ಬ ಿ ದ ್ ದ ಿ ತ ್ ತ ು |
ಬಿದ್ದು	ಬ ಿ ದ ್ ದ ು |
ಬಿನ್ನಿ	ಬ ಿ ನ ್ ನ ಿ |
ಬಿಮಾನಿ	ಬ ಿ ಮ ಾ ನ ಿ |
ಬಿರ್	ಬ ಿ ರ ್ |
ಬಿಲಾಸ್	ಬ ಿ ಲ ಾ ಸ ್ |
ಬಿಳಿ	ಬ ಿ ಳ ಿ |
ಬಿಳಿಗಿರಿ	ಬ ಿ ಳ ಿ ಗ ಿ ರ ಿ |
ಬಿವಿ	ಬ ಿ ವ ಿ |
ಬಿಶೇಶ್ವರ್	ಬ ಿ ಶ ೇ ಶ ್ ವ ರ ್ |
ಬಿಷನ್	ಬ ಿ ಷ ನ ್ |
ಬಿಸಿ	ಬ ಿ ಸ ಿ |
ಬಿಸಿಲು	ಬ ಿ ಸ ಿ ಲ ು |
ಬಿಹಾರಿ	ಬ ಿ ಹ ಾ ರ ಿ |
ಬಿಹಾರ್	ಬ ಿ ಹ ಾ ರ ್ |
ಬೀಕಾನೇರ್	ಬ ೀ ಕ ಾ ನ ೇ ರ ್ |
ಬೀಚಿ	ಬ ೀ ಚ ಿ |
ಬೀಜ	ಬ ೀ ಜ |
ಬೀದರ್	ಬ ೀ ದ ರ ್ |
ಬೀದಿ	ಬ ೀ ದ ಿ |
ಬೀದಿಯಲ್ಲಿ	ಬ ೀ ದ ಿ ಯ ಲ ್ ಲ ಿ |
ಬೀರು	ಬ ೀ ರ ು |
ಬೀಳು	ಬ ೀ ಳ ು |
ಬೀಳುತ್ತೀಯೆ	ಬ ೀ ಳ ು ತ ್ ತ ೀ ಯ ೆ |
ಬೀಹರ್	ಬ ೀ ಹ ರ ್ |
ಬುಕ್ಕ	ಬ ು ಕ ್ ಕ |
ಬುಟ್ಟಿ	ಬ ು ಟ ್ ಟ ಿ |
ಬುಟ್ಟಿಯ	ಬ ು ಟ ್ ಟ ಿ ಯ |
ಬುಟ್ಟೋ	ಬ ು ಟ ್ ಟ ೋ |
ಬುಡ	ಬ ು ಡ |
ಬುಡಕ್ಕೆ	ಬ ು ಡ ಕ ್ ಕ ೆ |
ಬುದ್ಧಿ	ಬ ು ದ ್ ಧ ಿ |
ಬುಧ	ಬ ು ಧ |
ಬುಧವಾರ	ಬ ು ಧ ವ ಾ ರ |
ಬುಲಂದ್	ಬ ು ಲ ಂ ದ ್ |
ಬುಷ್	ಬ ು ಷ ್ |
ಬೂದಿ	ಬ ೂ ದ ಿ |
ಬೂದಿಯನ್ನು	ಬ ೂ ದ ಿ ಯ ನ ್ ನ ು |
ಬೂನ್	ಬ ೂ ನ ್ |
ಬೃಹತ್	ಬ ೃ ಹ ತ ್ |
ಬೆಂಕಿ	ಬ ೆ ಂ ಕ ಿ |
ಬೆಂಗಳೂರು	ಬ ೆ ಂ ಗ ಳ ೂ ರ ು |
ಬೆಂಬಲ	ಬ ೆ ಂ ಬ ಲ |
ಬೆಂಬಲಿಗ	ಬ ೆ ಂ ಬ ಲ ಿ ಗ |
ಬೆಟ್ಟ	ಬ ೆ ಟ ್ ಟ |
ಬೆನಜೀರ್	ಬ ೆ ನ ಜ ೀ ರ ್ |
ಬೆನೆಗಲ್	ಬ ೆ ನ ೆ ಗ ಲ ್ |
ಬೆನ್	ಬ ೆ ನ ್ |
ಬೆನ್ನ	ಬ ೆ ನ ್ ನ |
ಬೆನ್ನು	ಬ ೆ ನ ್ ನ ು |
ಬೆರಮೊ	ಬ ೆ ರ ಮ ೊ |
ಬೆರಳು	ಬ ೆ ರ ಳ ು |
ಬೆಲೆ	ಬ ೆ ಲ ೆ |
ಬೆಲೆಯಲ್ಲಿ	ಬ ೆ ಲ ೆ ಯ ಲ ್ ಲ ಿ |
ಬೆಲ್	ಬ ೆ ಲ ್ |
ಬೆಲ್ಲಾರಿ	ಬ ೆ ಲ ್ ಲ ಾ ರ ಿ |
ಬೆಳಕು	ಬ ೆ ಳ ಕ ು |
ಬೆಳಗಾವಿ	ಬ ೆ ಳ ಗ ಾ ವ ಿ |
ಬೆಳಗ್ಗೆ	ಬ ೆ ಳ ಗ ್ ಗ ೆ |
ಬೆಳವಣಿಗೆ	ಬ ೆ ಳ ವ ಣ ಿ ಗ ೆ |
ಬೆಳಿಗ್ಗೆ	ಬ ೆ ಳ ಿ ಗ ್ ಗ ೆ |
ಬೆಳೆ	ಬ ೆ ಳ ೆ |
ಬೆಳೆದು	ಬ ೆ ಳ ೆ ದ ು |
ಬೆಳೆಯು	ಬ ೆ ಳ ೆ ಯ ು |
ಬೆಳೆಯುತ್ತದೆ	ಬ ೆ ಳ ೆ ಯ ು ತ ್ ತ ದ ೆ |
ಬೆಳೆಯುತ್ತಾರೆ	ಬ ೆ ಳ ೆ ಯ ು ತ ್ ತ ಾ ರ ೆ |
ಬೆಳೆಸು	ಬ ೆ ಳ ೆ ಸ ು |
ಬೆಳ್ತಂಗಡಿ	ಬ ೆ ಳ ್ ತ ಂ ಗ ಡ ಿ |
ಬೆಳ್ಳಿ	ಬ ೆ ಳ ್ ಳ ಿ |
ಬೆಳ್ಳಿಯಿಂದ	ಬ ೆ ಳ ್ ಳ ಿ ಯ ಿ ಂ ದ |
ಬೇಂದ್ರೆ	ಬ ೇ ಂ ದ ್ ರ ೆ |
ಬೇಕಾಗು	ಬ ೇ ಕ ಾ ಗ ು |
ಬೇಕಾದ	ಬ ೇ ಕ ಾ ದ |
ಬೇಕು	ಬ ೇ ಕ ು |
ಬೇಗ	ಬ ೇ ಗ |
ಬೇಗುಸರಾಯ್	ಬ ೇ ಗ ು ಸ ರ ಾ ಯ ್ |
ಬೇಡ	ಬ ೇ ಡ |
ಬೇಡಿ	ಬ ೇ ಡ ಿ |
ಬೇಡಿಕೆ	ಬ ೇ ಡ ಿ ಕ ೆ |
ಬೇರನ್ನು	ಬ ೇ ರ ನ ್ ನ ು |
ಬೇರು	ಬ ೇ ರ ು |
ಬೇರೆ	ಬ ೇ ರ ೆ |
ಬೇಲಿ	ಬ ೇ ಲ ಿ |
ಬೇಲಿಯನ್ನು	ಬ ೇ ಲ ಿ ಯ ನ ್ ನ ು |
ಬೇಲೂರು	ಬ ೇ ಲ ೂ ರ ು |
ಬೇಸಿಗೆ	ಬ ೇ ಸ ಿ ಗ ೆ |
ಬೈತೂಲ್	ಬ ೈ ತ ೂ ಲ ್ |
ಬೈರಾನ್	ಬ ೈ ರ ಾ ನ ್ |
ಬೊಮ್ಮಾಯಿ	ಬ ೊ ಮ ್ ಮ ಾ ಯ ಿ |
ಬೋಕಾರೋ	ಬ ೋ ಕ ಾ ರ ೋ |
ಬೋಸ್	ಬ ೋ ಸ ್ |
ಬೌಚರ್	ಬ ೌ ಚ ರ ್ |
ಬ್ಯಾಂಕು	ಬ ್ ಯ ಾ ಂ ಕ ು |
ಬ್ಯಾಡ	ಬ ್ ಯ ಾ ಡ |
ಬ್ಯಾಡಗಿ	ಬ ್ ಯ ಾ ಡ ಗ ಿ |
ಬ್ಯಾಡರಹಳ್ಳಿ	ಬ ್ ಯ ಾ ಡ ರ ಹ ಳ ್ ಳ ಿ |
ಬ್ರಾಡ್	ಬ ್ ರ ಾ ಡ ್ |
ಬ್ರಾಹ್ಮಣ	ಬ ್ ರ ಾ ಹ ್ ಮ ಣ |
ಬ್ರಿಜೋಶ್	ಬ ್ ರ ಿ ಜ ೋ ಶ ್ |
ಬ್ರೂಸ್ಲಿ	ಬ ್ ರ ೂ ಸ ್ ಲ ಿ |
ಬ್ರೈನ್	ಬ ್ ರ ೈ ನ ್ |
ಬ್ಲೇಯೈರ್	ಬ ್ ಲ ೇ ಯ ೈ ರ ್ |
ಬ್ಲೇರ್	ಬ ್ ಲ ೇ ರ ್ |
ಭಕ್ತ	ಭ ಕ ್ ತ |
ಭಕ್ತಿ	ಭ ಕ ್ ತ ಿ |
ಭಗತ್	ಭ ಗ ತ ್ |
ಭಗವಂತ	ಭ ಗ ವ ಂ ತ |
ಭಜನ್	ಭ ಜ ನ ್ |
ಭಟಿಯಾ	ಭ ಟ ಿ ಯ ಾ |
ಭಟ್ಕಳ	ಭ ಟ ್ ಕ ಳ |
ಭಟ್ಟ	ಭ ಟ ್ ಟ |
ಭಟ್ಟಾರ್ಯ	ಭ ಟ ್ ಟ ಾ ರ ್ ಯ |
ಭದ್ರಕ್	ಭ ದ ್ ರ ಕ ್ |
ಭದ್ರಾವತಿ	ಭ ದ ್ ರ ಾ ವ ತ ಿ |
ಭಯ	ಭ ಯ |
ಭರತ್	ಭ ರ ತ ್ |
ಭರವಸೆ	ಭ ರ ವ ಸ ೆ |
ಭವಿಷ್ಯ	ಭ ವ ಿ ಷ ್ ಯ |
ಭಸ್ಮ	ಭ ಸ ್ ಮ |
ಭಾಂಗಾ	ಭ ಾ ಂ ಗ ಾ |
ಭಾಗ	ಭ ಾ ಗ |
ಭಾಗಲ್	ಭ ಾ ಗ ಲ ್ |
ಭಾಗವಹಿಸು	ಭ ಾ ಗ ವ ಹ ಿ ಸ ು |
ಭಾಗ್ಯ	ಭ ಾ ಗ ್ ಯ |
ಭಾನುವಾರ	ಭ ಾ ನ ು ವ ಾ ರ |
ಭಾನುವಾರದ	ಭ ಾ ನ ು ವ ಾ ರ ದ |
ಭಾಮೈದ	ಭ ಾ ಮ ೈ ದ |
ಭಾರತೀಯ	ಭ ಾ ರ ತ ೀ ಯ |
ಭಾರಿ	ಭ ಾ ರ ಿ |
ಭಾರೀ	ಭ ಾ ರ ೀ |
ಭಾವ	ಭ ಾ ವ |
ಭಾವನೆ	ಭ ಾ ವ ನ ೆ |
ಭಾವಿಸು	ಭ ಾ ವ ಿ ಸ ು |
ಭಾಷಣ	ಭ ಾ ಷ ಣ |
ಭಾಷೆ	ಭ ಾ ಷ ೆ |
ಭಾಷೆಗಳಲ್ಲಿ	ಭ ಾ ಷ ೆ ಗ ಳ ಲ ್ ಲ ಿ |
ಭಿಂಡ್	ಭ ಿ ಂ ಡ ್ |
ಭಿನ್ನ	ಭ ಿ ನ ್ ನ |
ಭಿಲಾಯ್	ಭ ಿ ಲ ಾ ಯ ್ |
ಭೀಮ್	ಭ ೀ ಮ ್ |
ಭೀಲ್	ಭ ೀ ಲ ್ |
ಭುಜ	ಭ ು ಜ |
ಭುಜ್	ಭ ು ಜ ್ |
ಭುವನೇಶ್ವರ್	ಭ ು ವ ನ ೇ ಶ ್ ವ ರ ್ |
ಭೂಪತಿ	ಭ ೂ ಪ ತ ಿ |
ಭೂಮಿ	ಭ ೂ ಮ ಿ |
ಭೇಟಿ	ಭ ೇ ಟ ಿ |
ಭೈರಪ್ಪ	ಭ ೈ ರ ಪ ್ ಪ |
ಭೋಪಾಲ್	ಭ ೋ ಪ ಾ ಲ ್ |
ಭ್ರಮೆ	ಭ ್ ರ ಮ ೆ |
ಭ್ರಷ್ಟಾಚಾರ	ಭ ್ ರ ಷ ್ ಟ ಾ ಚ ಾ ರ |
ಮಂಗಳ	ಮ ಂ ಗ ಳ |
ಮಂಗಳವಾರ	ಮ ಂ ಗ ಳ ವ ಾ ರ |
ಮಂಗೇಶ್ಕರ್	ಮ ಂ ಗ ೇ ಶ ್ ಕ ರ ್ |
ಮಂಚ	ಮ ಂ ಚ |
ಮಂಜು	ಮ ಂ ಜ ು |
ಮಂಡಲ	ಮ ಂ ಡ ಲ |
ಮಂಡಳಿ	ಮ ಂ ಡ ಳ ಿ |
ಮಂಡಿ	ಮ ಂ ಡ ಿ |
ಮಂಡಿಸು	ಮ ಂ ಡ ಿ ಸ ು |
ಮಂಡ್ಯ	ಮ ಂ ಡ ್ ಯ |
ಮಂತ್ರ	ಮ ಂ ತ ್ ರ |
ಮಂತ್ರಿ	ಮ ಂ ತ ್ ರ ಿ |
ಮಂದಿ	ಮ ಂ ದ ಿ |
ಮಕರ	ಮ ಕ ರ |
ಮಕ್ಕಳಿಗೆ	ಮ ಕ ್ ಕ ಳ ಿ ಗ ೆ |
ಮಕ್ಕಳು	ಮ ಕ ್ ಕ ಳ ು |
ಮಗ	ಮ ಗ |
ಮಗಳು	ಮ ಗ ಳ ು |
ಮಗು	ಮ ಗ ು |
ಮಗೂ	ಮ ಗ ೂ |
ಮಗ್ಗ	ಮ ಗ ್ ಗ |
ಮಚ್ಚೆ	ಮ ಚ ್ ಚ ೆ |
ಮಜುಂದಾರ್	ಮ ಜ ು ಂ ದ ಾ ರ ್ |
ಮಜ್ಜರಸ	ಮ ಜ ್ ಜ ರ ಸ |
ಮಟ್ಟ	ಮ ಟ ್ ಟ |
ಮಠ	ಮ ಠ |
ಮಡಕೇರಿ	ಮ ಡ ಕ ೇ ರ ಿ |
ಮಣಿಕಟ್ಟು	ಮ ಣ ಿ ಕ ಟ ್ ಟ ು |
ಮಣೆಯನ್ನು	ಮ ಣ ೆ ಯ ನ ್ ನ ು |
ಮಣ್ಣು	ಮ ಣ ್ ಣ ು |
ಮತ	ಮ ತ |
ಮತದಾರ	ಮ ತ ದ ಾ ರ |
ಮತದಿಂದ	ಮ ತ ದ ಿ ಂ ದ |
ಮತ್ತಷ್ಟು	ಮ ತ ್ ತ ಷ ್ ಟ ು |
ಮತ್ತಿತರ	ಮ ತ ್ ತ ಿ ತ ರ |
ಮತ್ತು	ಮ ತ ್ ತ ು |
ಮತ್ತೆ	ಮ ತ ್ ತ ೆ |
ಮಥುರಾ	ಮ ಥ ು ರ ಾ |
ಮದುರೈ	ಮ ದ ು ರ ೈ |
ಮದುವೆ	ಮ ದ ು ವ ೆ |
ಮದುವೆಗಳಲ್ಲಿ	ಮ ದ ು ವ ೆ ಗ ಳ ಲ ್ ಲ ಿ |
ಮದುವೆಗೆ	ಮ ದ ು ವ ೆ ಗ ೆ |
ಮದ್ದೂರು	ಮ ದ ್ ದ ೂ ರ ು |
ಮಧುಗಿರಿ	ಮ ಧ ು ಗ ಿ ರ ಿ |
ಮಧುಬನೀ	ಮ ಧ ು ಬ ನ ೀ |
ಮಧೇಪುರಾ	ಮ ಧ ೇ ಪ ು ರ ಾ |
ಮಧ್ಯ	ಮ ಧ ್ ಯ |
ಮಧ್ಯಮ	ಮ ಧ ್ ಯ ಮ |
ಮಧ್ಯಾಹ್ನ	ಮ ಧ ್ ಯ ಾ ಹ ್ ನ |
ಮಧ್ಯೆ	ಮ ಧ ್ ಯ ೆ |
ಮನ	ಮ ನ |
ಮನಮೋಹನ್	ಮ ನ ಮ ೋ ಹ ನ ್ |
ಮನವಿ	ಮ ನ ವ ಿ |
ಮನಸ್ಸು	ಮ ನ ಸ ್ ಸ ು |
ಮನೀಂದರ್	ಮ ನ ೀ ಂ ದ ರ ್ |
ಮನುಷ್ಯ	ಮ ನ ು ಷ ್ ಯ |
ಮನುಷ್ಯನಾಗುತ್ತೀಯ	ಮ ನ ು ಷ ್ ಯ ನ ಾ ಗ ು ತ ್ ತ ೀ ಯ |
ಮನೆ	ಮ ನ ೆ |
ಮನೆಗೆ	ಮ ನ ೆ ಗ ೆ |
ಮನೆಯ	ಮ ನ ೆ ಯ |
ಮನೆಯಲ್ಲಿ	ಮ ನ ೆ ಯ ಲ ್ ಲ ಿ |
ಮನೆಯವರು	ಮ ನ ೆ ಯ ವ ರ ು |
ಮನೋಜ್	ಮ ನ ೋ ಜ ್ |
ಮನೋಭಾವ	ಮ ನ ೋ ಭ ಾ ವ |
ಮನೋಹರ	ಮ ನ ೋ ಹ ರ |
ಮನೋಹರ್	ಮ ನ ೋ ಹ ರ ್ |
ಮನ್	ಮ ನ ್ |
ಮನ್ಸೂರ್	ಮ ನ ್ ಸ ೂ ರ ್ |
ಮಮತಾ	ಮ ಮ ತ ಾ |
ಮಮ್ಮುಟ್ಟಿ	ಮ ಮ ್ ಮ ು ಟ ್ ಟ ಿ |
ಮಯೂರ	ಮ ಯ ೂ ರ |
ಮರ	ಮ ರ |
ಮರಣ	ಮ ರ ಣ |
ಮರಳು	ಮ ರ ಳ ು |
ಮರಾಠಿ	ಮ ರ ಾ ಠ ಿ |
ಮರೀ	ಮ ರ ೀ |
ಮರೆ	ಮ ರ ೆ |
ಮರೆತು	ಮ ರ ೆ ತ ು |
ಮರ್ಮ	ಮ ರ ್ ಮ |
ಮಲಗಿವೆ	ಮ ಲ ಗ ಿ ವ ೆ |
ಮಲಗು	ಮ ಲ ಗ ು |
ಮಲುಗಲು	ಮ ಲ ು ಗ ಲ ು |
ಮಲೈಕಾ	ಮ ಲ ೈ ಕ ಾ |
ಮಲ್ಯ	ಮ ಲ ್ ಯ |
ಮಲ್ಲಿಕಾ	ಮ ಲ ್ ಲ ಿ ಕ ಾ |
ಮಲ್ಲಿಕಾರ್ಜುನ	ಮ ಲ ್ ಲ ಿ ಕ ಾ ರ ್ ಜ ು ನ |
ಮಲ್ಲಿಕ್	ಮ ಲ ್ ಲ ಿ ಕ ್ |
ಮಲ್ಲಿಗೆರೆ	ಮ ಲ ್ ಲ ಿ ಗ ೆ ರ ೆ |
ಮಲ್ಹೋತ್ರ	ಮ ಲ ್ ಹ ೋ ತ ್ ರ |
ಮಳವಳ್ಳಿ	ಮ ಳ ವ ಳ ್ ಳ ಿ |
ಮಳೆ	ಮ ಳ ೆ |
ಮಳೆಗಾಲ	ಮ ಳ ೆ ಗ ಾ ಲ |
ಮವಾನಾ	ಮ ವ ಾ ನ ಾ |
ಮಸೀದಿ	ಮ ಸ ೀ ದ ಿ |
ಮಸೂದ್	ಮ ಸ ೂ ದ ್ |
ಮಸೂರೀ	ಮ ಸ ೂ ರ ೀ |
ಮಹತ್ವ	ಮ ಹ ತ ್ ವ |
ಮಹಾ	ಮ ಹ ಾ |
ಮಹಾನ್	ಮ ಹ ಾ ನ ್ |
ಮಹಾಭಾರತ	ಮ ಹ ಾ ಭ ಾ ರ ತ |
ಮಹಾರಾಜ	ಮ ಹ ಾ ರ ಾ ಜ |
ಮಹಿಳೆ	ಮ ಹ ಿ ಳ ೆ |
ಮಹೇಂದ್ರ	ಮ ಹ ೇ ಂ ದ ್ ರ |
ಮಹೇಶ್	ಮ ಹ ೇ ಶ ್ |
ಮಹೊಹಮ್ಮದ್	ಮ ಹ ೊ ಹ ಮ ್ ಮ ದ ್ |
ಮಾಂಟೋ	ಮ ಾ ಂ ಟ ೋ |
ಮಾಕಿಶನ್	ಮ ಾ ಕ ಿ ಶ ನ ್ |
ಮಾಗಡಿ	ಮ ಾ ಗ ಡ ಿ |
ಮಾಘ	ಮ ಾ ಘ |
ಮಾಜಿ	ಮ ಾ ಜ ಿ |
ಮಾಟ	ಮ ಾ ಟ |
ಮಾಡಬೇಕು	ಮ ಾ ಡ ಬ ೇ ಕ ು |
ಮಾಡಬೇಡ	ಮ ಾ ಡ ಬ ೇ ಡ |
ಮಾಡಿ	ಮ ಾ ಡ ಿ |
ಮಾಡಿಕೊಳ್ಳುತ್ತಾನೆ	ಮ ಾ ಡ ಿ ಕ ೊ ಳ ್ ಳ ು ತ ್ ತ ಾ ನ ೆ |
ಮಾಡಿದಂತೆ	ಮ ಾ ಡ ಿ ದ ಂ ತ ೆ |
ಮಾಡಿದರೂ	ಮ ಾ ಡ ಿ ದ ರ ೂ |
ಮಾಡಿಸುತ್ತಾರೆ	ಮ ಾ ಡ ಿ ಸ ು ತ ್ ತ ಾ ರ ೆ |
ಮಾಡು	ಮ ಾ ಡ ು |
ಮಾಡುತಿದ್ದರು	ಮ ಾ ಡ ು ತ ಿ ದ ್ ದ ರ ು |
ಮಾಡುತಿದ್ದೀನಿ	ಮ ಾ ಡ ು ತ ಿ ದ ್ ದ ೀ ನ ಿ |
ಮಾಡುತ್ತದೆ	ಮ ಾ ಡ ು ತ ್ ತ ದ ೆ |
ಮಾಡುತ್ತಾರೆ	ಮ ಾ ಡ ು ತ ್ ತ ಾ ರ ೆ |
ಮಾಡುತ್ತಿರುವ	ಮ ಾ ಡ ು ತ ್ ತ ಿ ರ ು ವ |
ಮಾಡುವಾಗ	ಮ ಾ ಡ ು ವ ಾ ಗ |
ಮಾಡುವುದಕ್ಕೆ	ಮ ಾ ಡ ು ವ ು ದ ಕ ್ ಕ ೆ |
ಮಾಡುವುದು	ಮ ಾ ಡ ು ವ ು ದ ು |
ಮಾತನಾಡುತ್ತಾನೆ	ಮ ಾ ತ ನ ಾ ಡ ು ತ ್ ತ ಾ ನ ೆ |
ಮಾತು	ಮ ಾ ತ ು |
ಮಾತುಕತೆ	ಮ ಾ ತ ು ಕ ತ ೆ |
ಮಾತ್ರ	ಮ ಾ ತ ್ ರ |
ಮಾತ್ರಿಕಾ	ಮ ಾ ತ ್ ರ ಿ ಕ ಾ |
ಮಾದರಿ	ಮ ಾ ದ ರ ಿ |
ಮಾಧವಾಚಾರ್ಯ	ಮ ಾ ಧ ವ ಾ ಚ ಾ ರ ್ ಯ |
ಮಾಧ್ಯಮ	ಮ ಾ ಧ ್ ಯ ಮ |
ಮಾನ	ಮ ಾ ನ |
ಮಾನವ	ಮ ಾ ನ ವ |
ಮಾನವೀಯ	ಮ ಾ ನ ವ ೀ ಯ |
ಮಾನಸಿಕ	ಮ ಾ ನ ಸ ಿ ಕ |
ಮಾನ್ಯ	ಮ ಾ ನ ್ ಯ |
ಮಾನ್ವಿ	ಮ ಾ ನ ್ ವ ಿ |
ಮಾಪನ	ಮ ಾ ಪ ನ |
ಮಾಬೇನ್	ಮ ಾ ಬ ೇ ನ ್ |
ಮಾರಾಟ	ಮ ಾ ರ ಾ ಟ |
ಮಾರ್ಕ	ಮ ಾ ರ ್ ಕ |
ಮಾರ್ಗ	ಮ ಾ ರ ್ ಗ |
ಮಾರ್ಗ್ರೇಟ್	ಮ ಾ ರ ್ ಗ ್ ರ ೇ ಟ ್ |
ಮಾರ್ಘಶಿರ	ಮ ಾ ರ ್ ಘ ಶ ಿ ರ |
ಮಾರ್ಚಿ	ಮ ಾ ರ ್ ಚ ಿ |
ಮಾರ್ವಾನ್	ಮ ಾ ರ ್ ವ ಾ ನ ್ |
ಮಾಲಶ್ರೀ	ಮ ಾ ಲ ಶ ್ ರ ೀ |
ಮಾಲಿನ್ಯ	ಮ ಾ ಲ ಿ ನ ್ ಯ |
ಮಾಲೂರು	ಮ ಾ ಲ ೂ ರ ು |
ಮಾವ	ಮ ಾ ವ |
ಮಾವಾಲಂಕರ್	ಮ ಾ ವ ಾ ಲ ಂ ಕ ರ ್ |
ಮಾಸ್ತಿ	ಮ ಾ ಸ ್ ತ ಿ |
ಮಾಹಿತಿ	ಮ ಾ ಹ ಿ ತ ಿ |
ಮಿಂಚು	ಮ ಿ ಂ ಚ ು |
ಮಿತುನ್	ಮ ಿ ತ ು ನ ್ |
ಮಿತ್ರ	ಮ ಿ ತ ್ ರ |
ಮಿಥುನ	ಮ ಿ ಥ ು ನ |
ಮಿರ್ಜಾ	ಮ ಿ ರ ್ ಜ ಾ |
ಮಿರ್ಜಾಪುರ್	ಮ ಿ ರ ್ ಜ ಾ ಪ ು ರ ್ |
ಮಿಲೆಟ್	ಮ ಿ ಲ ೆ ಟ ್ |
ಮಿಶ್ರ	ಮ ಿ ಶ ್ ರ |
ಮೀನ	ಮ ೀ ನ |
ಮೀನು	ಮ ೀ ನ ು |
ಮೀರಾಪುರ್	ಮ ೀ ರ ಾ ಪ ು ರ ್ |
ಮೀರು	ಮ ೀ ರ ು |
ಮೀಸಲಾತಿ	ಮ ೀ ಸ ಲ ಾ ತ ಿ |
ಮೀಸಲು	ಮ ೀ ಸ ಲ ು |
ಮುಂಚೆ	ಮ ು ಂ ಚ ೆ |
ಮುಂಜಾನೆ	ಮ ು ಂ ಜ ಾ ನ ೆ |
ಮುಂಡರಗಿ	ಮ ು ಂ ಡ ರ ಗ ಿ |
ಮುಂತಾದ	ಮ ು ಂ ತ ಾ ದ |
ಮುಂದಗೋಡು	ಮ ು ಂ ದ ಗ ೋ ಡ ು |
ಮುಂದಿನ	ಮ ು ಂ ದ ಿ ನ |
ಮುಂದುವರಿ	ಮ ು ಂ ದ ು ವ ರ ಿ |
ಮುಂದೆ	ಮ ು ಂ ದ ೆ |
ಮುಂಬರುವ	ಮ ು ಂ ಬ ರ ು ವ |
ಮುಂಬೈ	ಮ ು ಂ ಬ ೈ |
ಮುಕ್ತ	ಮ ು ಕ ್ ತ |
ಮುಖ	ಮ ು ಖ |
ಮುಖಂಡ	ಮ ು ಖ ಂ ಡ |
ಮುಖ್ಯ	ಮ ು ಖ ್ ಯ |
ಮುಖ್ಯಮಂತ್ರಿ	ಮ ು ಖ ್ ಯ ಮ ಂ ತ ್ ರ ಿ |
ಮುಗಿ	ಮ ು ಗ ಿ |
ಮುಚ್ಚು	ಮ ು ಚ ್ ಚ ು |
ಮುಜಫ್ಫರ್	ಮ ು ಜ ಫ ್ ಫ ರ ್ |
ಮುಝೀಬುರ್	ಮ ು ಝ ೀ ಬ ು ರ ್ |
ಮುಟ್ಟು	ಮ ು ಟ ್ ಟ ು |
ಮುತ್ತಯ್ಯ	ಮ ು ತ ್ ತ ಯ ್ ಯ |
ಮುದವೀಡು	ಮ ು ದ ವ ೀ ಡ ು |
ಮುದಿ	ಮ ು ದ ಿ |
ಮುದ್ದೆಬಿಹಾಳ	ಮ ು ದ ್ ದ ೆ ಬ ಿ ಹ ಾ ಳ |
ಮುಧೋಳ	ಮ ು ಧ ೋ ಳ |
ಮುನ್ನ	ಮ ು ನ ್ ನ |
ಮುನ್ನಡೆ	ಮ ು ನ ್ ನ ಡ ೆ |
ಮುರಳಿ	ಮ ು ರ ಳ ಿ |
ಮುರಳೀಧರನ್	ಮ ು ರ ಳ ೀ ಧ ರ ನ ್ |
ಮುರಿ	ಮ ು ರ ಿ |
ಮುರುಳಿ	ಮ ು ರ ು ಳ ಿ |
ಮುಳುಗಿತು	ಮ ು ಳ ು ಗ ಿ ತ ು |
ಮುಳುಬಾಗಿಲು	ಮ ು ಳ ು ಬ ಾ ಗ ಿ ಲ ು |
ಮುಷ್ತಕ್	ಮ ು ಷ ್ ತ ಕ ್ |
ಮುಷ್ರಾಫ್	ಮ ು ಷ ್ ರ ಾ ಫ ್ |
ಮುಸ್ತಾಖ್	ಮ ು ಸ ್ ತ ಾ ಖ ್ |
ಮೂಗಿನ	ಮ ೂ ಗ ಿ ನ |
ಮೂಗು	ಮ ೂ ಗ ು |
ಮೂಡಗೆರೆ	ಮ ೂ ಡ ಗ ೆ ರ ೆ |
ಮೂಡು	ಮ ೂ ಡ ು |
ಮೂಢ	ಮ ೂ ಢ |
ಮೂತ್ರನಾಳ	ಮ ೂ ತ ್ ರ ನ ಾ ಳ |
ಮೂತ್ರಪಿಂಡ	ಮ ೂ ತ ್ ರ ಪ ಿ ಂ ಡ |
ಮೂನ್ನೂರು	ಮ ೂ ನ ್ ನ ೂ ರ ು |
ಮೂರನೆಯ	ಮ ೂ ರ ನ ೆ ಯ |
ಮೂರು	ಮ ೂ ರ ು |
ಮೂರ್ಖ	ಮ ೂ ರ ್ ಖ |
ಮೂರ್ತಿ	ಮ ೂ ರ ್ ತ ಿ |
ಮೂಲ	ಮ ೂ ಲ |
ಮೂಲಕ	ಮ ೂ ಲ ಕ |
ಮೂಲತಃ	ಮ ೂ ಲ ತ ಃ |
ಮೂಲಭೂತ	ಮ ೂ ಲ ಭ ೂ ತ |
ಮೂಳೆ	ಮ ೂ ಳ ೆ |
ಮೂಳೆಗಳಿಗೆ	ಮ ೂ ಳ ೆ ಗ ಳ ಿ ಗ ೆ |
ಮೂವತ್ತಾರು	ಮ ೂ ವ ತ ್ ತ ಾ ರ ು |
ಮೂವತ್ತು	ಮ ೂ ವ ತ ್ ತ ು |
ಮೂವತ್ತುಮೂರು	ಮ ೂ ವ ತ ್ ತ ು ಮ ೂ ರ ು |
ಮೂವತ್ತೆಂಟು	ಮ ೂ ವ ತ ್ ತ ೆ ಂ ಟ ು |
ಮೂವತ್ತೆರಡು	ಮ ೂ ವ ತ ್ ತ ೆ ರ ಡ ು |
ಮೂವತ್ತೇಳು	ಮ ೂ ವ ತ ್ ತ ೇ ಳ ು |
ಮೂವತ್ತೈದು	ಮ ೂ ವ ತ ್ ತ ೈ ದ ು |
ಮೂವತ್ತೊಂದು	ಮ ೂ ವ ತ ್ ತ ೊ ಂ ದ ು |
ಮೂವತ್ತೊಂಬತ್ತು	ಮ ೂ ವ ತ ್ ತ ೊ ಂ ಬ ತ ್ ತ ು |
ಮೂವತ್ನಾಕು	ಮ ೂ ವ ತ ್ ನ ಾ ಕ ು |
ಮೃದುಲಾ	ಮ ೃ ದ ು ಲ ಾ |
ಮೃದುವಾಗುತ್ತದೆ	ಮ ೃ ದ ು ವ ಾ ಗ ು ತ ್ ತ ದ ೆ |
ಮೆಚೂರಿ	ಮ ೆ ಚ ೂ ರ ಿ |
ಮೆಟ್ಟಿಲು	ಮ ೆ ಟ ್ ಟ ಿ ಲ ು |
ಮೆಟ್ಟಿಲುಗಳನ್ನು	ಮ ೆ ಟ ್ ಟ ಿ ಲ ು ಗ ಳ ನ ್ ನ ು |
ಮೆದು	ಮ ೆ ದ ು |
ಮೆದುಳು	ಮ ೆ ದ ು ಳ ು |
ಮೆದುವಾಗಿದೆ	ಮ ೆ ದ ು ವ ಾ ಗ ಿ ದ ೆ |
ಮೆದುವಾಗಿದ್ದರೆ	ಮ ೆ ದ ು ವ ಾ ಗ ಿ ದ ್ ದ ರ ೆ |
ಮೆರ್	ಮ ೆ ರ ್ |
ಮೆಹಂದಿ	ಮ ೆ ಹ ಂ ದ ಿ |
ಮೆಹಸಾಣಾ	ಮ ೆ ಹ ಸ ಾ ಣ ಾ |
ಮೇ	ಮ ೇ |
ಮೇಘ	ಮ ೇ ಘ |
ಮೇಜಿನ	ಮ ೇ ಜ ಿ ನ |
ಮೇರಠ್	ಮ ೇ ರ ಠ ್ |
ಮೇರೆ	ಮ ೇ ರ ೆ |
ಮೇಲಿದ್ದ	ಮ ೇ ಲ ಿ ದ ್ ದ |
ಮೇಲು	ಮ ೇ ಲ ು |
ಮೇಲುಕೋಟೆ	ಮ ೇ ಲ ು ಕ ೋ ಟ ೆ |
ಮೇಲೆ	ಮ ೇ ಲ ೆ |
ಮೇಷ	ಮ ೇ ಷ |
ಮೈ	ಮ ೈ |
ಮೈಕೇಲ್	ಮ ೈ ಕ ೇ ಲ ್ |
ಮೈತ್ರಿ	ಮ ೈ ತ ್ ರ ಿ |
ಮೈದಾನ	ಮ ೈ ದ ಾ ನ |
ಮೈದುನ	ಮ ೈ ದ ು ನ |
ಮೈಸೂರು	ಮ ೈ ಸ ೂ ರ ು |
ಮೊಂಗ್ಯ	ಮ ೊ ಂ ಗ ್ ಯ |
ಮೊಣಕಲ್ಮೂರು	ಮ ೊ ಣ ಕ ಲ ್ ಮ ೂ ರ ು |
ಮೊಣಕೈ	ಮ ೊ ಣ ಕ ೈ |
ಮೊತ್ತ	ಮ ೊ ತ ್ ತ |
ಮೊದಲನೆಯ	ಮ ೊ ದ ಲ ನ ೆ ಯ |
ಮೊದಲಾದ	ಮ ೊ ದ ಲ ಾ ದ |
ಮೊದಲು	ಮ ೊ ದ ಲ ು |
ಮೊಮ್ಮಗ	ಮ ೊ ಮ ್ ಮ ಗ |
ಮೊಮ್ಮಗಳು	ಮ ೊ ಮ ್ ಮ ಗ ಳ ು |
ಮೊಲ	ಮ ೊ ಲ |
ಮೊಳಕೈ	ಮ ೊ ಳ ಕ ೈ |
ಮೊಸಳೆ	ಮ ೊ ಸ ಳ ೆ |
ಮೊಸಳೆಗಳೆಲ್ಲ	ಮ ೊ ಸ ಳ ೆ ಗ ಳ ೆ ಲ ್ ಲ |
ಮೊಹಂತಿ	ಮ ೊ ಹ ಂ ತ ಿ |
ಮೊಹಮ್ಮದ	ಮ ೊ ಹ ಮ ್ ಮ ದ |
ಮೊಹಮ್ಮದ್	ಮ ೊ ಹ ಮ ್ ಮ ದ ್ |
ಮೊಹೊಮ್ಮದ್	ಮ ೊ ಹ ೊ ಮ ್ ಮ ದ ್ |
ಮೋಕೋಕಚುಆಂಗ್	ಮ ೋ ಕ ೋ ಕ ಚ ು ಆ ಂ ಗ ್ |
ಮೋಟಾರು	ಮ ೋ ಟ ಾ ರ ು |
ಮೋಡ	ಮ ೋ ಡ |
ಮೋಡಗಳು	ಮ ೋ ಡ ಗ ಳ ು |
ಮೋತಿಹಾರೀ	ಮ ೋ ತ ಿ ಹ ಾ ರ ೀ |
ಮೋಯ್ನುದ್ದೀನ್	ಮ ೋ ಯ ್ ನ ು ದ ್ ದ ೀ ನ ್ |
ಮೋಹನ್	ಮ ೋ ಹ ನ ್ |
ಮೋಹಿಂದರ್	ಮ ೋ ಹ ಿ ಂ ದ ರ ್ |
ಮೌನ	ಮ ೌ ನ |
ಮೌಲ್ಯ	ಮ ೌ ಲ ್ ಯ |
ಮೌಶಿಂ	ಮ ೌ ಶ ಿ ಂ |
ಮ್ಯಾನ್	ಮ ್ ಯ ಾ ನ ್ |
ಯಂತ್ರ	ಯ ಂ ತ ್ ರ |
ಯಡಿಯೂರಪ್ಪ	ಯ ಡ ಿ ಯ ೂ ರ ಪ ್ ಪ |
ಯತ್ನ	ಯ ತ ್ ನ |
ಯಲಬುರ್ಗಾ	ಯ ಲ ಬ ು ರ ್ ಗ ಾ |
ಯಲಿಯೂರು	ಯ ಲ ಿ ಯ ೂ ರ ು |
ಯವ್ವನ	ಯ ವ ್ ವ ನ |
ಯಶವಂತ	ಯ ಶ ವ ಂ ತ |
ಯಶಸ್ವಿ	ಯ ಶ ಸ ್ ವ ಿ |
ಯಶಸ್ಸು	ಯ ಶ ಸ ್ ಸ ು |
ಯಶ್ವಂತ್	ಯ ಶ ್ ವ ಂ ತ ್ |
ಯಾಕೆ	ಯ ಾ ಕ ೆ |
ಯಾತ್ರೆ	ಯ ಾ ತ ್ ರ ೆ |
ಯಾದಗಿರಿ	ಯ ಾ ದ ಗ ಿ ರ ಿ |
ಯಾದವ್	ಯ ಾ ದ ವ ್ |
ಯಾರ	ಯ ಾ ರ |
ಯಾರಿಗೆ	ಯ ಾ ರ ಿ ಗ ೆ |
ಯಾರು	ಯ ಾ ರ ು |
ಯಾರೋ	ಯ ಾ ರ ೋ |
ಯಾವ	ಯ ಾ ವ |
ಯಾವಗಲೂ	ಯ ಾ ವ ಗ ಲ ೂ |
ಯಾವಾಗ	ಯ ಾ ವ ಾ ಗ |
ಯಾವಾಗಲು	ಯ ಾ ವ ಾ ಗ ಲ ು |
ಯಾವಾಗಲೂ	ಯ ಾ ವ ಾ ಗ ಲ ೂ |
ಯಾವುದದರೂ	ಯ ಾ ವ ು ದ ದ ರ ೂ |
ಯಾವುದು	ಯ ಾ ವ ು ದ ು |
ಯಾವುದೇ	ಯ ಾ ವ ು ದ ೇ |
ಯಾಹ್ಯಾ	ಯ ಾ ಹ ್ ಯ ಾ |
ಯು	ಯ ು |
ಯುಆರ್	ಯ ು ಆ ರ ್ |
ಯುಕ್ತಿ	ಯ ು ಕ ್ ತ ಿ |
ಯುಗ	ಯ ು ಗ |
ಯುಗಾದಿ	ಯ ು ಗ ಾ ದ ಿ |
ಯುದ್ಧ	ಯ ು ದ ್ ಧ |
ಯುರೇನಸ್	ಯ ು ರ ೇ ನ ಸ ್ |
ಯುವ	ಯ ು ವ |
ಯುವಕ	ಯ ು ವ ಕ |
ಯುಹಾನ್ನ	ಯ ು ಹ ಾ ನ ್ ನ |
ಯೂನಿಸ್	ಯ ೂ ನ ಿ ಸ ್ |
ಯೂಸಫ್	ಯ ೂ ಸ ಫ ್ |
ಯೆಲ್ಲಾಪುರ	ಯ ೆ ಲ ್ ಲ ಾ ಪ ು ರ |
ಯೋಚನೆ	ಯ ೋ ಚ ನ ೆ |
ಯೋಚಿಸು	ಯ ೋ ಚ ಿ ಸ ು |
ಯೋಜನೆ	ಯ ೋ ಜ ನ ೆ |
ರಂಗ	ರ ಂ ಗ |
ರಂಗನಬೆಟ್ಟ	ರ ಂ ಗ ನ ಬ ೆ ಟ ್ ಟ |
ರಂಗಭೂಮಿ	ರ ಂ ಗ ಭ ೂ ಮ ಿ |
ರಂಗಸ್ವಾಮಿ	ರ ಂ ಗ ಸ ್ ವ ಾ ಮ ಿ |
ರಂಗಾಚಾರ್ಲು	ರ ಂ ಗ ಾ ಚ ಾ ರ ್ ಲ ು |
ರಂಗಾರೆಡ್ಡಿ	ರ ಂ ಗ ಾ ರ ೆ ಡ ್ ಡ ಿ |
ರಕ್ತ	ರ ಕ ್ ತ |
ರಕ್ಷಣೆ	ರ ಕ ್ ಷ ಣ ೆ |
ರಕ್ಷಿತ	ರ ಕ ್ ಷ ಿ ತ |
ರಕ್ಷಿಸಲು	ರ ಕ ್ ಷ ಿ ಸ ಲ ು |
ರಚನೆ	ರ ಚ ನ ೆ |
ರಚಿಸು	ರ ಚ ಿ ಸ ು |
ರಜಿನಿಕಾಂತ್	ರ ಜ ಿ ನ ಿ ಕ ಾ ಂ ತ ್ |
ರಜೆ	ರ ಜ ೆ |
ರಜೆಯಲ್ಲಿ	ರ ಜ ೆ ಯ ಲ ್ ಲ ಿ |
ರಟ್ಚೆ	ರ ಟ ್ ಚ ೆ |
ರಣಧೀರ್	ರ ಣ ಧ ೀ ರ ್ |
ರಣವೀರ್	ರ ಣ ವ ೀ ರ ್ |
ರತ್	ರ ತ ್ |
ರತ್ನ	ರ ತ ್ ನ |
ರತ್ನಾಗಢ್	ರ ತ ್ ನ ಾ ಗ ಢ ್ |
ರತ್ನಾಗಿರಿ	ರ ತ ್ ನ ಾ ಗ ಿ ರ ಿ |
ರನ್ನ	ರ ನ ್ ನ |
ರಮೀಜ್	ರ ಮ ೀ ಜ ್ |
ರಮೇಶ್	ರ ಮ ೇ ಶ ್ |
ರಮ್ಯಾ	ರ ಮ ್ ಯ ಾ |
ರವಿಚಂದ್ರನ್	ರ ವ ಿ ಚ ಂ ದ ್ ರ ನ ್ |
ರವಿದಾಸ್	ರ ವ ಿ ದ ಾ ಸ ್ |
ರವಿಶಾಸ್ತ್ರಿ	ರ ವ ಿ ಶ ಾ ಸ ್ ತ ್ ರ ಿ |
ರಸ್ತೆ	ರ ಸ ್ ತ ೆ |
ರಸ್ತೆಯಲ್ಲಿ	ರ ಸ ್ ತ ೆ ಯ ಲ ್ ಲ ಿ |
ರಹಸ್ಯ	ರ ಹ ಸ ್ ಯ |
ರಾ	ರ ಾ |
ರಾಂ	ರ ಾ ಂ |
ರಾಂಚೀ	ರ ಾ ಂ ಚ ೀ |
ರಾಗಿ	ರ ಾ ಗ ಿ |
ರಾಘವೇಂದ್ರ	ರ ಾ ಘ ವ ೇ ಂ ದ ್ ರ |
ರಾಘವ್	ರ ಾ ಘ ವ ್ |
ರಾಜ	ರ ಾ ಜ |
ರಾಜಕಾರಣ	ರ ಾ ಜ ಕ ಾ ರ ಣ |
ರಾಜಕಾರಣಿ	ರ ಾ ಜ ಕ ಾ ರ ಣ ಿ |
ರಾಜಕೀಯ	ರ ಾ ಜ ಕ ೀ ಯ |
ರಾಜಕುಮಾರ್	ರ ಾ ಜ ಕ ು ಮ ಾ ರ ್ |
ರಾಜಗುರು	ರ ಾ ಜ ಗ ು ರ ು |
ರಾಜಗೋಪಾಲಚಾರಿ	ರ ಾ ಜ ಗ ೋ ಪ ಾ ಲ ಚ ಾ ರ ಿ |
ರಾಜರತ್ನಮ್	ರ ಾ ಜ ರ ತ ್ ನ ಮ ್ |
ರಾಜರಾಮಣ್ಣ	ರ ಾ ಜ ರ ಾ ಮ ಣ ್ ಣ |
ರಾಜಾ	ರ ಾ ಜ ಾ |
ರಾಜೀನಾಮೆ	ರ ಾ ಜ ೀ ನ ಾ ಮ ೆ |
ರಾಜೀವ್	ರ ಾ ಜ ೀ ವ ್ |
ರಾಜು	ರ ಾ ಜ ು |
ರಾಜೇಂದ್ರ	ರ ಾ ಜ ೇ ಂ ದ ್ ರ |
ರಾಜೇಶ್	ರ ಾ ಜ ೇ ಶ ್ |
ರಾಜೇಸಿಂಧಿಯಾ	ರ ಾ ಜ ೇ ಸ ಿ ಂ ಧ ಿ ಯ ಾ |
ರಾಜೋರಿ	ರ ಾ ಜ ೋ ರ ಿ |
ರಾಜ್	ರ ಾ ಜ ್ |
ರಾಜ್ಯ	ರ ಾ ಜ ್ ಯ |
ರಾಜ್ಯಪಾಲ	ರ ಾ ಜ ್ ಯ ಪ ಾ ಲ |
ರಾಣಾ	ರ ಾ ಣ ಾ |
ರಾಣಿ	ರ ಾ ಣ ಿ |
ರಾಣಿಬೆನ್ನೂರು	ರ ಾ ಣ ಿ ಬ ೆ ನ ್ ನ ೂ ರ ು |
ರಾತ್ರಿ	ರ ಾ ತ ್ ರ ಿ |
ರಾತ್ರಿಯ	ರ ಾ ತ ್ ರ ಿ ಯ |
ರಾತ್ರಿಯಲ್ಲಿ	ರ ಾ ತ ್ ರ ಿ ಯ ಲ ್ ಲ ಿ |
ರಾಧಾಕೃಷ್ಣ	ರ ಾ ಧ ಾ ಕ ೃ ಷ ್ ಣ |
ರಾಧಿಕ	ರ ಾ ಧ ಿ ಕ |
ರಾಬಿನ್	ರ ಾ ಬ ಿ ನ ್ |
ರಾಮಕೃಷ್ಣ	ರ ಾ ಮ ಕ ೃ ಷ ್ ಣ |
ರಾಮಗಢ್	ರ ಾ ಮ ಗ ಢ ್ |
ರಾಮಚಂದ್ರನ್	ರ ಾ ಮ ಚ ಂ ದ ್ ರ ನ ್ |
ರಾಮನಗರ	ರ ಾ ಮ ನ ಗ ರ |
ರಾಮನಾಥಪುರಂ	ರ ಾ ಮ ನ ಾ ಥ ಪ ು ರ ಂ |
ರಾಮನ್	ರ ಾ ಮ ನ ್ |
ರಾಮಸ್ವಾಮಿ	ರ ಾ ಮ ಸ ್ ವ ಾ ಮ ಿ |
ರಾಮಾರಾವ್	ರ ಾ ಮ ಾ ರ ಾ ವ ್ |
ರಾಮ್	ರ ಾ ಮ ್ |
ರಾಯಚೂರು	ರ ಾ ಯ ಚ ೂ ರ ು |
ರಾಯಬರೇಲಿ	ರ ಾ ಯ ಬ ರ ೇ ಲ ಿ |
ರಾಯಬಾಗ್	ರ ಾ ಯ ಬ ಾ ಗ ್ |
ರಾಯರಂಗಪುರ್	ರ ಾ ಯ ರ ಂ ಗ ಪ ು ರ ್ |
ರಾಯ್	ರ ಾ ಯ ್ |
ರಾವಲ್	ರ ಾ ವ ಲ ್ |
ರಾವ್	ರ ಾ ವ ್ |
ರಾವ್ನತ್	ರ ಾ ವ ್ ನ ತ ್ |
ರಾಶಿ	ರ ಾ ಶ ಿ |
ರಾಷ್ಟ್ರ	ರ ಾ ಷ ್ ಟ ್ ರ |
ರಾಷ್ಟ್ರಪತಿ	ರ ಾ ಷ ್ ಟ ್ ರ ಪ ತ ಿ |
ರಾಷ್ಟ್ರೀಯ	ರ ಾ ಷ ್ ಟ ್ ರ ೀ ಯ |
ರಾಹುಲ್	ರ ಾ ಹ ು ಲ ್ |
ರಿಖಿ	ರ ಿ ಖ ಿ |
ರಿಚರ್ಡ್	ರ ಿ ಚ ರ ್ ಡ ್ |
ರಿಚರ್ಡ್ಸ್	ರ ಿ ಚ ರ ್ ಡ ್ ಸ ್ |
ರಿಷಿ	ರ ಿ ಷ ಿ |
ರೀತಿ	ರ ೀ ತ ಿ |
ರೀತಿಯ	ರ ೀ ತ ಿ ಯ |
ರೀವಾ	ರ ೀ ವ ಾ |
ರುಚಿ	ರ ು ಚ ಿ |
ರುಚಿಯಾಗಿರುತ್ತದೆ	ರ ು ಚ ಿ ಯ ಾ ಗ ಿ ರ ು ತ ್ ತ ದ ೆ |
ರುದ್ರಪ್ರಯಾಗ್	ರ ು ದ ್ ರ ಪ ್ ರ ಯ ಾ ಗ ್ |
ರೂಢ	ರ ೂ ಢ |
ರೂಪ	ರ ೂ ಪ |
ರೂಪಾಯಿ	ರ ೂ ಪ ಾ ಯ ಿ |
ರೂಪಿಸು	ರ ೂ ಪ ಿ ಸ ು |
ರೂಮಲಿಂಗಯ್ಯ	ರ ೂ ಮ ಲ ಿ ಂ ಗ ಯ ್ ಯ |
ರೆಪ್ಪೆ	ರ ೆ ಪ ್ ಪ ೆ |
ರೆಹಮಾನ್	ರ ೆ ಹ ಮ ಾ ನ ್ |
ರೇ	ರ ೇ |
ರೇಗನ್	ರ ೇ ಗ ನ ್ |
ರೇಗು	ರ ೇ ಗ ು |
ರೇಶ್ಮಿಯ	ರ ೇ ಶ ್ ಮ ಿ ಯ |
ರೈತ	ರ ೈ ತ |
ರೊನಾಲ್ಡ್	ರ ೊ ನ ಾ ಲ ್ ಡ ್ |
ರೋಗ	ರ ೋ ಗ |
ರೋಗನಿರೋಧಕ	ರ ೋ ಗ ನ ಿ ರ ೋ ಧ ಕ |
ರೋಗರ್	ರ ೋ ಗ ರ ್ |
ರೋಣ	ರ ೋ ಣ |
ರೋಪಡ್	ರ ೋ ಪ ಡ ್ |
ರೋಸ್ಡಾ	ರ ೋ ಸ ್ ಡ ಾ |
ರೋಹನ್	ರ ೋ ಹ ನ ್ |
ಲಂಕೇಶ್	ಲ ಂ ಕ ೇ ಶ ್ |
ಲಕ್ಷ	ಲ ಕ ್ ಷ |
ಲಕ್ಷಣ	ಲ ಕ ್ ಷ ಣ |
ಲಕ್ಷ್ಮಣಯ್ಯ	ಲ ಕ ್ ಷ ್ ಮ ಣ ಯ ್ ಯ |
ಲಕ್ಷ್ಮಣ್	ಲ ಕ ್ ಷ ್ ಮ ಣ ್ |
ಲಕ್ಷ್ಮೀ	ಲ ಕ ್ ಷ ್ ಮ ೀ |
ಲಕ್ಷ್ಮ್ಣಣ್	ಲ ಕ ್ ಷ ್ ಮ ್ ಣ ಣ ್ |
ಲಖೀಮ್	ಲ ಖ ೀ ಮ ್ |
ಲಖ್	ಲ ಖ ್ |
ಲಡಾಖ್	ಲ ಡ ಾ ಖ ್ |
ಲತಾ	ಲ ತ ಾ |
ಲನ್	ಲ ನ ್ |
ಲಭಿಸು	ಲ ಭ ಿ ಸ ು |
ಲಾಂಗ್	ಲ ಾ ಂ ಗ ್ |
ಲಾಗಢ್	ಲ ಾ ಗ ಢ ್ |
ಲಾಡು	ಲ ಾ ಡ ು |
ಲಾಡ್ನು	ಲ ಾ ಡ ್ ನ ು |
ಲಾಭ	ಲ ಾ ಭ |
ಲಾಮ್	ಲ ಾ ಮ ್ |
ಲಾಯ್ಡ್	ಲ ಾ ಯ ್ ಡ ್ |
ಲಾರಾ	ಲ ಾ ರ ಾ |
ಲಾರಾದತ್ತ	ಲ ಾ ರ ಾ ದ ತ ್ ತ |
ಲಾಲಾ	ಲ ಾ ಲ ಾ |
ಲಾಲು	ಲ ಾ ಲ ು |
ಲಾಲ್	ಲ ಾ ಲ ್ |
ಲಿಂಗ	ಲ ಿ ಂ ಗ |
ಲಿಂಗಸೂರು	ಲ ಿ ಂ ಗ ಸ ೂ ರ ು |
ಲಿಗಾಡೆ	ಲ ಿ ಗ ಾ ಡ ೆ |
ಲಿಪಿ	ಲ ಿ ಪ ಿ |
ಲಿವರ್	ಲ ಿ ವ ರ ್ |
ಲಿವಾನಾರ್ಡೋ	ಲ ಿ ವ ಾ ನ ಾ ರ ್ ಡ ೋ |
ಲೀಟರ್	ಲ ೀ ಟ ರ ್ |
ಲೀನಾ	ಲ ೀ ನ ಾ |
ಲುಧಿಯಾನ	ಲ ು ಧ ಿ ಯ ಾ ನ |
ಲೆಕ್ಕ	ಲ ೆ ಕ ್ ಕ |
ಲೆಕ್ಕಾಚಾರ	ಲ ೆ ಕ ್ ಕ ಾ ಚ ಾ ರ |
ಲೆಹ್	ಲ ೆ ಹ ್ |
ಲೇಖಕ	ಲ ೇ ಖ ಕ |
ಲೇಖನ	ಲ ೇ ಖ ನ |
ಲೋಕ	ಲ ೋ ಕ |
ಲೋಕಸಭೆ	ಲ ೋ ಕ ಸ ಭ ೆ |
ಲೋಹರ್	ಲ ೋ ಹ ರ ್ |
ವಚನ	ವ ಚ ನ |
ವಜ್ರ	ವ ಜ ್ ರ |
ವದೋದರಾ	ವ ದ ೋ ದ ರ ಾ |
ವನ	ವ ನ |
ವಯಸ್ಸು	ವ ಯ ಸ ್ ಸ ು |
ವರದಿ	ವ ರ ದ ಿ |
ವರಾಹಗಿರಿ	ವ ರ ಾ ಹ ಗ ಿ ರ ಿ |
ವರಿಷ್ಠ	ವ ರ ಿ ಷ ್ ಠ |
ವರುಷ	ವ ರ ು ಷ |
ವರ್ಗ	ವ ರ ್ ಗ |
ವರ್ಣನೆ	ವ ರ ್ ಣ ನ ೆ |
ವರ್ತನೆ	ವ ರ ್ ತ ನ ೆ |
ವರ್ಧಾ	ವ ರ ್ ಧ ಾ |
ವರ್ಮ	ವ ರ ್ ಮ |
ವರ್ಷ	ವ ರ ್ ಷ |
ವರ್ಷಗಳಿಗೊಮ್ಮೆ	ವ ರ ್ ಷ ಗ ಳ ಿ ಗ ೊ ಮ ್ ಮ ೆ |
ವಲಯ	ವ ಲ ಯ |
ವಲ್ಲಬಾಯಿ	ವ ಲ ್ ಲ ಬ ಾ ಯ ಿ |
ವಲ್ಲಭಘಢ್	ವ ಲ ್ ಲ ಭ ಘ ಢ ್ |
ವಸಂತ	ವ ಸ ಂ ತ |
ವಸುಂದರಾ	ವ ಸ ು ಂ ದ ರ ಾ |
ವಸ್ತು	ವ ಸ ್ ತ ು |
ವಹಿಸು	ವ ಹ ಿ ಸ ು |
ವಾಕ್	ವ ಾ ಕ ್ |
ವಾಕ್ಯ	ವ ಾ ಕ ್ ಯ |
ವಾಖರ್	ವ ಾ ಖ ರ ್ |
ವಾಜಪೇಯಿ	ವ ಾ ಜ ಪ ೇ ಯ ಿ |
ವಾಟಾಳ್	ವ ಾ ಟ ಾ ಳ ್ |
ವಾಡಾ	ವ ಾ ಡ ಾ |
ವಾಡೇಕರ	ವ ಾ ಡ ೇ ಕ ರ |
ವಾಣಿ	ವ ಾ ಣ ಿ |
ವಾತಾವರಣ	ವ ಾ ತ ಾ ವ ರ ಣ |
ವಾತ್ಸಾಯನ	ವ ಾ ತ ್ ಸ ಾ ಯ ನ |
ವಾದ	ವ ಾ ದ |
ವಾದೇರಾ	ವ ಾ ದ ೇ ರ ಾ |
ವಾದ್ಯ	ವ ಾ ದ ್ ಯ |
ವಾದ್ಯಗಳು	ವ ಾ ದ ್ ಯ ಗ ಳ ು |
ವಾಪಸ್	ವ ಾ ಪ ಸ ್ |
ವಾಪಸ್ಸು	ವ ಾ ಪ ಸ ್ ಸ ು |
ವಾಯು	ವ ಾ ಯ ು |
ವಾಯುವ್ಯ	ವ ಾ ಯ ು ವ ್ ಯ |
ವಾರ	ವ ಾ ರ |
ವಾರಂಗಲ್	ವ ಾ ರ ಂ ಗ ಲ ್ |
ವಾರಾಣಾಸಿಬನಾರಸ್	ವ ಾ ರ ಾ ಣ ಾ ಸ ಿ ಬ ನ ಾ ರ ಸ ್ |
ವಾಲ್ಕರ್	ವ ಾ ಲ ್ ಕ ರ ್ |
ವಾಸಿಂ	ವ ಾ ಸ ಿ ಂ |
ವಾಸಿನ್	ವ ಾ ಸ ಿ ನ ್ |
ವಾಸಿಸುವ	ವ ಾ ಸ ಿ ಸ ು ವ |
ವಾಸುದೇವ್	ವ ಾ ಸ ು ದ ೇ ವ ್ |
ವಾಸ್ಕೋ	ವ ಾ ಸ ್ ಕ ೋ |
ವಾಸ್ತವ	ವ ಾ ಸ ್ ತ ವ |
ವಾಹನ	ವ ಾ ಹ ನ |
ವಿ	ವ ಿ |
ವಿಕಾಸ	ವ ಿ ಕ ಾ ಸ |
ವಿಚಾರ	ವ ಿ ಚ ಾ ರ |
ವಿಚಾರಗಳನ್ನು	ವ ಿ ಚ ಾ ರ ಗ ಳ ನ ್ ನ ು |
ವಿಚಾರಣೆ	ವ ಿ ಚ ಾ ರ ಣ ೆ |
ವಿಚಿತ್ರ	ವ ಿ ಚ ಿ ತ ್ ರ |
ವಿಜಯ	ವ ಿ ಜ ಯ |
ವಿಜಯವಾಡಾ	ವ ಿ ಜ ಯ ವ ಾ ಡ ಾ |
ವಿಜಯಶಂಕರ	ವ ಿ ಜ ಯ ಶ ಂ ಕ ರ |
ವಿಜಯ್	ವ ಿ ಜ ಯ ್ |
ವಿಜ್ಞಾನ	ವ ಿ ಜ ್ ಞ ಾ ನ |
ವಿಜ್ಞಾನಿ	ವ ಿ ಜ ್ ಞ ಾ ನ ಿ |
ವಿತರ್ನ	ವ ಿ ತ ರ ್ ನ |
ವಿದೇಶಿ	ವ ಿ ದ ೇ ಶ ಿ |
ವಿದ್ಯಾರಣ್ಯ	ವ ಿ ದ ್ ಯ ಾ ರ ಣ ್ ಯ |
ವಿದ್ಯಾರ್ಥಿ	ವ ಿ ದ ್ ಯ ಾ ರ ್ ಥ ಿ |
ವಿದ್ಯುತ್ತು	ವ ಿ ದ ್ ಯ ು ತ ್ ತ ು |
ವಿದ್ವಾಂಸ	ವ ಿ ದ ್ ವ ಾ ಂ ಸ |
ವಿಧ	ವ ಿ ಧ |
ವಿಧಾನ	ವ ಿ ಧ ಾ ನ |
ವಿಧಾನಸಭೆ	ವ ಿ ಧ ಾ ನ ಸ ಭ ೆ |
ವಿಧಿ	ವ ಿ ಧ ಿ |
ವಿಧೂ	ವ ಿ ಧ ೂ |
ವಿನೋದ	ವ ಿ ನ ೋ ದ |
ವಿನೋದ್	ವ ಿ ನ ೋ ದ ್ |
ವಿಪರೀತ	ವ ಿ ಪ ರ ೀ ತ |
ವಿಫಲ	ವ ಿ ಫ ಲ |
ವಿಭಾಗ	ವ ಿ ಭ ಾ ಗ |
ವಿಮರ್ಶಕ	ವ ಿ ಮ ರ ್ ಶ ಕ |
ವಿಮರ್ಶೆ	ವ ಿ ಮ ರ ್ ಶ ೆ |
ವಿಮಲ್	ವ ಿ ಮ ಲ ್ |
ವಿಮಾನ	ವ ಿ ಮ ಾ ನ |
ವಿಮೆ	ವ ಿ ಮ ೆ |
ವಿರಹ	ವ ಿ ರ ಹ |
ವಿರಾಮ	ವ ಿ ರ ಾ ಮ |
ವಿರುದ್ಧ	ವ ಿ ರ ು ದ ್ ಧ |
ವಿರೋಧ	ವ ಿ ರ ೋ ಧ |
ವಿರೋಧಿ	ವ ಿ ರ ೋ ಧ ಿ |
ವಿಲಾಸಪುರ್	ವ ಿ ಲ ಾ ಸ ಪ ು ರ ್ |
ವಿಲಿಯಮ್	ವ ಿ ಲ ಿ ಯ ಮ ್ |
ವಿಳಾಸ	ವ ಿ ಳ ಾ ಸ |
ವಿವರ	ವ ಿ ವ ರ |
ವಿವರಣೆ	ವ ಿ ವ ರ ಣ ೆ |
ವಿವರಿಸು	ವ ಿ ವ ರ ಿ ಸ ು |
ವಿವಾದ	ವ ಿ ವ ಾ ದ |
ವಿವಾಹ	ವ ಿ ವ ಾ ಹ |
ವಿವಿಎಸ್	ವ ಿ ವ ಿ ಎ ಸ ್ |
ವಿವಿಧ	ವ ಿ ವ ಿ ಧ |
ವಿವಿಯನ್	ವ ಿ ವ ಿ ಯ ನ ್ |
ವಿಶಾಂತ್	ವ ಿ ಶ ಾ ಂ ತ ್ |
ವಿಶಾಖಾಪಟ್ನಂ	ವ ಿ ಶ ಾ ಖ ಾ ಪ ಟ ್ ನ ಂ |
ವಿಶಾಲ	ವ ಿ ಶ ಾ ಲ |
ವಿಶಿಷ್ಟ	ವ ಿ ಶ ಿ ಷ ್ ಟ |
ವಿಶೇಷ	ವ ಿ ಶ ೇ ಷ |
ವಿಶ್ರಾಂತಿ	ವ ಿ ಶ ್ ರ ಾ ಂ ತ ಿ |
ವಿಶ್ಲೇಷಣೆ	ವ ಿ ಶ ್ ಲ ೇ ಷ ಣ ೆ |
ವಿಶ್ವ	ವ ಿ ಶ ್ ವ |
ವಿಶ್ವನಾಥ್	ವ ಿ ಶ ್ ವ ನ ಾ ಥ ್ |
ವಿಶ್ವವಿದ್ಯಾನಿಲಯ	ವ ಿ ಶ ್ ವ ವ ಿ ದ ್ ಯ ಾ ನ ಿ ಲ ಯ |
ವಿಶ್ವವಿದ್ಯಾಲಯ	ವ ಿ ಶ ್ ವ ವ ಿ ದ ್ ಯ ಾ ಲ ಯ |
ವಿಶ್ವಾಸ	ವ ಿ ಶ ್ ವ ಾ ಸ |
ವಿಶ್ವೇಶ್ವರಯ್ಯ	ವ ಿ ಶ ್ ವ ೇ ಶ ್ ವ ರ ಯ ್ ಯ |
ವಿಷ	ವ ಿ ಷ |
ವಿಷಯ	ವ ಿ ಷ ಯ |
ವಿಷಯಕ್ಕಾಗಿ	ವ ಿ ಷ ಯ ಕ ್ ಕ ಾ ಗ ಿ |
ವಿಷ್ಣು	ವ ಿ ಷ ್ ಣ ು |
ವಿಷ್ಣುವರ್ಧನ	ವ ಿ ಷ ್ ಣ ು ವ ರ ್ ಧ ನ |
ವಿಷ್ಣುವರ್ಧನ್	ವ ಿ ಷ ್ ಣ ು ವ ರ ್ ಧ ನ ್ |
ವೀಣಾ	ವ ೀ ಣ ಾ |
ವೀಣೆ	ವ ೀ ಣ ೆ |
ವೀರಭದ್ರಪ್ಪ	ವ ೀ ರ ಭ ದ ್ ರ ಪ ್ ಪ |
ವೀರಶೈವ	ವ ೀ ರ ಶ ೈ ವ |
ವೀಳ್ಯ	ವ ೀ ಳ ್ ಯ |
ವೃತ್ತಿ	ವ ೃ ತ ್ ತ ಿ |
ವೃಶ್ಚಿಕ	ವ ೃ ಶ ್ ಚ ಿ ಕ |
ವೃಷಭ	ವ ೃ ಷ ಭ |
ವೆಂಕಟಗಿರಿ	ವ ೆ ಂ ಕ ಟ ಗ ಿ ರ ಿ |
ವೆಂಕಟಪತಿರಾಜು	ವ ೆ ಂ ಕ ಟ ಪ ತ ಿ ರ ಾ ಜ ು |
ವೆಂಕಟರಾಮಯ್ಯ	ವ ೆ ಂ ಕ ಟ ರ ಾ ಮ ಯ ್ ಯ |
ವೆಂಕಟರಾವ್	ವ ೆ ಂ ಕ ಟ ರ ಾ ವ ್ |
ವೆಂಕಟೇಶ	ವ ೆ ಂ ಕ ಟ ೇ ಶ |
ವೆಂಕಟೇಶ್	ವ ೆ ಂ ಕ ಟ ೇ ಶ ್ |
ವೆಂಕಟ್	ವ ೆ ಂ ಕ ಟ ್ |
ವೆಂಕಯ್ಯ	ವ ೆ ಂ ಕ ಯ ್ ಯ |
ವೆಂಗಸರ್ಕರ್	ವ ೆ ಂ ಗ ಸ ರ ್ ಕ ರ ್ |
ವೆಚ್ಚ	ವ ೆ ಚ ್ ಚ |
ವೆರಾವಲ	ವ ೆ ರ ಾ ವ ಲ |
ವೆಲ್ಲೂರ್	ವ ೆ ಲ ್ ಲ ೂ ರ ್ |
ವೇಗ	ವ ೇ ಗ |
ವೇದ	ವ ೇ ದ |
ವೇದಿಕೆ	ವ ೇ ದ ಿ ಕ ೆ |
ವೇಲಿ	ವ ೇ ಲ ಿ |
ವೇಳೆ	ವ ೇ ಳ ೆ |
ವೈಜ್ಞಾನಿಕ	ವ ೈ ಜ ್ ಞ ಾ ನ ಿ ಕ |
ವೈದ್ಯ	ವ ೈ ದ ್ ಯ |
ವೈಯಕ್ತಿಕ	ವ ೈ ಯ ಕ ್ ತ ಿ ಕ |
ವೈಶಾಖ	ವ ೈ ಶ ಾ ಖ |
ವ್ಯಕ್ತಪಡಿಸು	ವ ್ ಯ ಕ ್ ತ ಪ ಡ ಿ ಸ ು |
ವ್ಯಕ್ತಿ	ವ ್ ಯ ಕ ್ ತ ಿ |
ವ್ಯಕ್ತಿತ್ವ	ವ ್ ಯ ಕ ್ ತ ಿ ತ ್ ವ |
ವ್ಯತ್ಯಾಸ	ವ ್ ಯ ತ ್ ಯ ಾ ಸ |
ವ್ಯವಸ್ಥೆ	ವ ್ ಯ ವ ಸ ್ ಥ ೆ |
ವ್ಯವಹಾರ	ವ ್ ಯ ವ ಹ ಾ ರ |
ವ್ಯಾಪಕ	ವ ್ ಯ ಾ ಪ ಕ |
ವ್ಯಾಪಾರ	ವ ್ ಯ ಾ ಪ ಾ ರ |
ವ್ಯಾಪ್ತಿ	ವ ್ ಯ ಾ ಪ ್ ತ ಿ |
ಶಂಕರ	ಶ ಂ ಕ ರ |
ಶಂಕರ್	ಶ ಂ ಕ ರ ್ |
ಶಂಖ	ಶ ಂ ಖ |
ಶಂಶೇರ್	ಶ ಂ ಶ ೇ ರ ್ |
ಶಕುಂತಲಾ	ಶ ಕ ು ಂ ತ ಲ ಾ |
ಶಕ್ತಿ	ಶ ಕ ್ ತ ಿ |
ಶತಮಾನ	ಶ ತ ಮ ಾ ನ |
ಶತ್ರುಘ್ನ	ಶ ತ ್ ರ ು ಘ ್ ನ |
ಶನಿ	ಶ ನ ಿ |
ಶನಿವಾರ	ಶ ನ ಿ ವ ಾ ರ |
ಶನಿವಾರಸಂತೆ	ಶ ನ ಿ ವ ಾ ರ ಸ ಂ ತ ೆ |
ಶಬ್ದ	ಶ ಬ ್ ದ |
ಶಬ್ಧ	ಶ ಬ ್ ಧ |
ಶಮ್ಮಿ	ಶ ಮ ್ ಮ ಿ |
ಶರಣ	ಶ ರ ಣ |
ಶರತ್	ಶ ರ ತ ್ |
ಶರತ್ಕಾಲ	ಶ ರ ತ ್ ಕ ಾ ಲ |
ಶರದೃತು	ಶ ರ ದ ೃ ತ ು |
ಶರಾವತ್	ಶ ರ ಾ ವ ತ ್ |
ಶರೀಫ್	ಶ ರ ೀ ಫ ್ |
ಶರೀರ	ಶ ರ ೀ ರ |
ಶರ್ಮ	ಶ ರ ್ ಮ |
ಶಶಿಕುಮಾರ್	ಶ ಶ ಿ ಕ ು ಮ ಾ ರ ್ |
ಶಹರ್	ಶ ಹ ರ ್ |
ಶಹಾಪುರ್	ಶ ಹ ಾ ಪ ು ರ ್ |
ಶಾ	ಶ ಾ |
ಶಾಂತ	ಶ ಾ ಂ ತ |
ಶಾಂತಾರಾಮ್	ಶ ಾ ಂ ತ ಾ ರ ಾ ಮ ್ |
ಶಾಂತಿ	ಶ ಾ ಂ ತ ಿ |
ಶಾಂತೇಶ್ವರ	ಶ ಾ ಂ ತ ೇ ಶ ್ ವ ರ |
ಶಾಪ	ಶ ಾ ಪ |
ಶಾಯಿದ್	ಶ ಾ ಯ ಿ ದ ್ |
ಶಾರುಖ್	ಶ ಾ ರ ು ಖ ್ |
ಶಾಲೆ	ಶ ಾ ಲ ೆ |
ಶಾಶ್ವತ	ಶ ಾ ಶ ್ ವ ತ |
ಶಾಶ್ವತವಾಗಿ	ಶ ಾ ಶ ್ ವ ತ ವ ಾ ಗ ಿ |
ಶಾಸಕ	ಶ ಾ ಸ ಕ |
ಶಾಸನ	ಶ ಾ ಸ ನ |
ಶಾಸ್ತ್ರ	ಶ ಾ ಸ ್ ತ ್ ರ |
ಶಾಸ್ತ್ರಿ	ಶ ಾ ಸ ್ ತ ್ ರ ಿ |
ಶಿಕಾರಿಪುರ	ಶ ಿ ಕ ಾ ರ ಿ ಪ ು ರ |
ಶಿಕ್ಷಕ	ಶ ಿ ಕ ್ ಷ ಕ |
ಶಿಕ್ಷಣ	ಶ ಿ ಕ ್ ಷ ಣ |
ಶಿಕ್ಷೆ	ಶ ಿ ಕ ್ ಷ ೆ |
ಶಿನಮೊಗ್ಗ	ಶ ಿ ನ ಮ ೊ ಗ ್ ಗ |
ಶಿಬಿರ	ಶ ಿ ಬ ಿ ರ |
ಶಿಮಲಾ	ಶ ಿ ಮ ಲ ಾ |
ಶಿರಹಟ್ಟಿ	ಶ ಿ ರ ಹ ಟ ್ ಟ ಿ |
ಶಿರಾ	ಶ ಿ ರ ಾ |
ಶಿರ್ಸಿ	ಶ ಿ ರ ್ ಸ ಿ |
ಶಿಲಾಂಗ್	ಶ ಿ ಲ ಾ ಂ ಗ ್ |
ಶಿವಕುಮಾರ್	ಶ ಿ ವ ಕ ು ಮ ಾ ರ ್ |
ಶಿವಕೋಟ್ಯಾಚಾರ್ಯ	ಶ ಿ ವ ಕ ೋ ಟ ್ ಯ ಾ ಚ ಾ ರ ್ ಯ |
ಶಿವನಸಮುದ್ರ	ಶ ಿ ವ ನ ಸ ಮ ು ದ ್ ರ |
ಶಿವಪುರ	ಶ ಿ ವ ಪ ು ರ |
ಶಿವಮೊಗ್ಗದಲ್ಲಿ	ಶ ಿ ವ ಮ ೊ ಗ ್ ಗ ದ ಲ ್ ಲ ಿ |
ಶಿವಮೊಗ್ಗಾ	ಶ ಿ ವ ಮ ೊ ಗ ್ ಗ ಾ |
ಶಿವರಾಜ	ಶ ಿ ವ ರ ಾ ಜ |
ಶಿವರಾಜ್	ಶ ಿ ವ ರ ಾ ಜ ್ |
ಶಿವರಾಮ	ಶ ಿ ವ ರ ಾ ಮ |
ಶಿವರುದ್ರಪ್ಪ	ಶ ಿ ವ ರ ು ದ ್ ರ ಪ ್ ಪ |
ಶಿವಸಾಗರ್	ಶ ಿ ವ ಸ ಾ ಗ ರ ್ |
ಶಿವಾಯ	ಶ ಿ ವ ಾ ಯ |
ಶಿಶಿರ	ಶ ಿ ಶ ಿ ರ |
ಶಿಷ್ಯ	ಶ ಿ ಷ ್ ಯ |
ಶಿಸ್ತು	ಶ ಿ ಸ ್ ತ ು |
ಶೀಘ್ರ	ಶ ೀ ಘ ್ ರ |
ಶುಕ್ರ	ಶ ು ಕ ್ ರ |
ಶುಕ್ರವಾರ	ಶ ು ಕ ್ ರ ವ ಾ ರ |
ಶುಚಿಯಾಗಿ	ಶ ು ಚ ಿ ಯ ಾ ಗ ಿ |
ಶುದ್ಧ	ಶ ು ದ ್ ಧ |
ಶುಭಕಾರ್ಯಗಳಿಗೆ	ಶ ು ಭ ಕ ಾ ರ ್ ಯ ಗ ಳ ಿ ಗ ೆ |
ಶುಭ್ರವಾಗಿಟ್ಟುಕೊಳ್ಳಬೇಕು	ಶ ು ಭ ್ ರ ವ ಾ ಗ ಿ ಟ ್ ಟ ು ಕ ೊ ಳ ್ ಳ ಬ ೇ ಕ ು |
ಶೃಂಗೇರಿ	ಶ ೃ ಂ ಗ ೇ ರ ಿ |
ಶೃತಿ	ಶ ೃ ತ ಿ |
ಶೆಖಾವತ್	ಶ ೆ ಖ ಾ ವ ತ ್ |
ಶೇಕಡಾ	ಶ ೇ ಕ ಡ ಾ |
ಶೇಖರಣೆಯಾಗುತ್ತದೆ	ಶ ೇ ಖ ರ ಣ ೆ ಯ ಾ ಗ ು ತ ್ ತ ದ ೆ |
ಶೈಕ್ಷಣಿಕ	ಶ ೈ ಕ ್ ಷ ಣ ಿ ಕ |
ಶೈಲಿ	ಶ ೈ ಲ ಿ |
ಶೋರಾಪುರ್	ಶ ೋ ರ ಾ ಪ ು ರ ್ |
ಶ್ಯಾಮ್	ಶ ್ ಯ ಾ ಮ ್ |
ಶ್ರದ್ಧೆ	ಶ ್ ರ ದ ್ ಧ ೆ |
ಶ್ರಮ	ಶ ್ ರ ಮ |
ಶ್ರವಣಬೆಳಗೊಳ	ಶ ್ ರ ವ ಣ ಬ ೆ ಳ ಗ ೊ ಳ |
ಶ್ರಾವಣ	ಶ ್ ರ ಾ ವ ಣ |
ಶ್ರೀ	ಶ ್ ರ ೀ |
ಶ್ರೀಕಾಂತ್	ಶ ್ ರ ೀ ಕ ಾ ಂ ತ ್ |
ಶ್ರೀಕಾಕುಲಮ್	ಶ ್ ರ ೀ ಕ ಾ ಕ ು ಲ ಮ ್ |
ಶ್ರೀಗಂಗಾನಗರ್	ಶ ್ ರ ೀ ಗ ಂ ಗ ಾ ನ ಗ ರ ್ |
ಶ್ರೀನಗರ್	ಶ ್ ರ ೀ ನ ಗ ರ ್ |
ಶ್ರೀನಾಥ್	ಶ ್ ರ ೀ ನ ಾ ಥ ್ |
ಶ್ರೀನಿವಾಸ	ಶ ್ ರ ೀ ನ ಿ ವ ಾ ಸ |
ಶ್ರೀನಿವಾಸನ್	ಶ ್ ರ ೀ ನ ಿ ವ ಾ ಸ ನ ್ |
ಶ್ರೀನಿವಾಸಪುರ	ಶ ್ ರ ೀ ನ ಿ ವ ಾ ಸ ಪ ು ರ |
ಶ್ರೀನಿವಾಸರಾವ್	ಶ ್ ರ ೀ ನ ಿ ವ ಾ ಸ ರ ಾ ವ ್ |
ಶ್ರೀಮಂತ	ಶ ್ ರ ೀ ಮ ಂ ತ |
ಶ್ರೀಮತಿ	ಶ ್ ರ ೀ ಮ ತ ಿ |
ಶ್ರೀರಂಗಪಟ್ಟಣ	ಶ ್ ರ ೀ ರ ಂ ಗ ಪ ಟ ್ ಟ ಣ |
ಶ್ರೀವಾತ್ಸ	ಶ ್ ರ ೀ ವ ಾ ತ ್ ಸ |
ಶ್ರೀವಾಸ್ತ	ಶ ್ ರ ೀ ವ ಾ ಸ ್ ತ |
ಶ್ರೀವಿಜಯ	ಶ ್ ರ ೀ ವ ಿ ಜ ಯ |
ಶ್ರೇಷ್ಠ	ಶ ್ ರ ೇ ಷ ್ ಠ |
ಶ್ವಾನ	ಶ ್ ವ ಾ ನ |
ಶ್ವಾಸಕೋಶ	ಶ ್ ವ ಾ ಸ ಕ ೋ ಶ |
ಶ್ವೇತ	ಶ ್ ವ ೇ ತ |
ಷಡ್ಡ್	ಷ ಡ ್ ಡ ್ |
ಷರಾಬು	ಷ ರ ಾ ಬ ು |
ಷರೀಫ್	ಷ ರ ೀ ಫ ್ |
ಷಷ್ಠಿ	ಷ ಷ ್ ಠ ಿ |
ಷಾಹಿಬ್	ಷ ಾ ಹ ಿ ಬ ್ |
ಷೇಕ್	ಷ ೇ ಕ ್ |
ಷೋಕಿ	ಷ ೋ ಕ ಿ |
ಸಂಕಲನ	ಸ ಂ ಕ ಲ ನ |
ಸಂಕೇತ	ಸ ಂ ಕ ೇ ತ |
ಸಂಕ್ಲೈನ್	ಸ ಂ ಕ ್ ಲ ೈ ನ ್ |
ಸಂಖ್ಯೆ	ಸ ಂ ಖ ್ ಯ ೆ |
ಸಂಗತಿ	ಸ ಂ ಗ ತ ಿ |
ಸಂಗೀತ	ಸ ಂ ಗ ೀ ತ |
ಸಂಗೀತಕ್ಕೆ	ಸ ಂ ಗ ೀ ತ ಕ ್ ಕ ೆ |
ಸಂಗೀತದಲ್ಲಿ	ಸ ಂ ಗ ೀ ತ ದ ಲ ್ ಲ ಿ |
ಸಂಗ್ರಹ	ಸ ಂ ಗ ್ ರ ಹ |
ಸಂಗ್ರಹಿಸಿ	ಸ ಂ ಗ ್ ರ ಹ ಿ ಸ ಿ |
ಸಂಘ	ಸ ಂ ಘ |
ಸಂಘಟನೆ	ಸ ಂ ಘ ಟ ನ ೆ |
ಸಂಘಮೇಶ್	ಸ ಂ ಘ ಮ ೇ ಶ ್ |
ಸಂಘರ್ಷ	ಸ ಂ ಘ ರ ್ ಷ |
ಸಂಚಿ	ಸ ಂ ಚ ಿ |
ಸಂಚು	ಸ ಂ ಚ ು |
ಸಂಜಯ್	ಸ ಂ ಜ ಯ ್ |
ಸಂಜೀವರೆಡ್ಡಿ	ಸ ಂ ಜ ೀ ವ ರ ೆ ಡ ್ ಡ ಿ |
ಸಂಜೆ	ಸ ಂ ಜ ೆ |
ಸಂತ	ಸ ಂ ತ |
ಸಂತೆ	ಸ ಂ ತ ೆ |
ಸಂತೆಯಲ್ಲಿ	ಸ ಂ ತ ೆ ಯ ಲ ್ ಲ ಿ |
ಸಂತೋಷ	ಸ ಂ ತ ೋ ಷ |
ಸಂತ್	ಸ ಂ ತ ್ |
ಸಂದರ್ಭ	ಸ ಂ ದ ರ ್ ಭ |
ಸಂದೀಪ್	ಸ ಂ ದ ೀ ಪ ್ |
ಸಂದು	ಸ ಂ ದ ು |
ಸಂದೇಶ	ಸ ಂ ದ ೇ ಶ |
ಸಂಧು	ಸ ಂ ಧ ು |
ಸಂಧ್ಯಾರಾಣಿ	ಸ ಂ ಧ ್ ಯ ಾ ರ ಾ ಣ ಿ |
ಸಂಪತ್ತು	ಸ ಂ ಪ ತ ್ ತ ು |
ಸಂಪರ್ಕ	ಸ ಂ ಪ ರ ್ ಕ |
ಸಂಪಾದನೆ	ಸ ಂ ಪ ಾ ದ ನ ೆ |
ಸಂಪುಟ	ಸ ಂ ಪ ು ಟ |
ಸಂಪೂರ್ಣ	ಸ ಂ ಪ ೂ ರ ್ ಣ |
ಸಂಪ್ರಾದಯಸ್ಥರು	ಸ ಂ ಪ ್ ರ ಾ ದ ಯ ಸ ್ ಥ ರ ು |
ಸಂಬಂಧ	ಸ ಂ ಬ ಂ ಧ |
ಸಂಬಧಿಕದಿರೆಲ್ಲ	ಸ ಂ ಬ ಧ ಿ ಕ ದ ಿ ರ ೆ ಲ ್ ಲ |
ಸಂಬಲ್	ಸ ಂ ಬ ಲ ್ |
ಸಂಭವ	ಸ ಂ ಭ ವ |
ಸಂಭ್ರಮ	ಸ ಂ ಭ ್ ರ ಮ |
ಸಂಯುಕ್ತ	ಸ ಂ ಯ ು ಕ ್ ತ |
ಸಂವಿಧಾನ	ಸ ಂ ವ ಿ ಧ ಾ ನ |
ಸಂಶಯ	ಸ ಂ ಶ ಯ |
ಸಂಶೋಧನೆ	ಸ ಂ ಶ ೋ ಧ ನ ೆ |
ಸಂಸತ್ತು	ಸ ಂ ಸ ತ ್ ತ ು |
ಸಂಸದ	ಸ ಂ ಸ ದ |
ಸಂಸಾರ	ಸ ಂ ಸ ಾ ರ |
ಸಂಸ್ಕೃತ	ಸ ಂ ಸ ್ ಕ ೃ ತ |
ಸಂಸ್ಕೃತಿ	ಸ ಂ ಸ ್ ಕ ೃ ತ ಿ |
ಸಂಸ್ಥೆ	ಸ ಂ ಸ ್ ಥ ೆ |
ಸಕಾರಾಂ	ಸ ಕ ಾ ರ ಾ ಂ |
ಸಕ್ಸೇನಾ	ಸ ಕ ್ ಸ ೇ ನ ಾ |
ಸಚಿದಾನಂದ	ಸ ಚ ಿ ದ ಾ ನ ಂ ದ |
ಸಚಿನ್	ಸ ಚ ಿ ನ ್ |
ಸಚಿವ	ಸ ಚ ಿ ವ |
ಸಜೆ	ಸ ಜ ೆ |
ಸಣ್ಣ	ಸ ಣ ್ ಣ |
ಸತತ	ಸ ತ ತ |
ಸತಾರಾ	ಸ ತ ಾ ರ ಾ |
ಸತ್ಗೋಪನ್	ಸ ತ ್ ಗ ೋ ಪ ನ ್ |
ಸತ್ತ	ಸ ತ ್ ತ |
ಸತ್ತು	ಸ ತ ್ ತ ು |
ಸತ್ಯ	ಸ ತ ್ ಯ |
ಸತ್ಯಜಿತ್	ಸ ತ ್ ಯ ಜ ಿ ತ ್ |
ಸತ್ಯು	ಸ ತ ್ ಯ ು |
ಸದನ	ಸ ದ ನ |
ಸದಸ್ಯ	ಸ ದ ಸ ್ ಯ |
ಸದಾ	ಸ ದ ಾ |
ಸದ್ಯ	ಸ ದ ್ ಯ |
ಸನತ್	ಸ ನ ತ ್ |
ಸನ್ನಿ	ಸ ನ ್ ನ ಿ |
ಸನ್ನಿವೇಶ	ಸ ನ ್ ನ ಿ ವ ೇ ಶ |
ಸಬೀರ್	ಸ ಬ ೀ ರ ್ |
ಸಭೆ	ಸ ಭ ೆ |
ಸಮ	ಸ ಮ |
ಸಮಕಾಲೀನ	ಸ ಮ ಕ ಾ ಲ ೀ ನ |
ಸಮಗ್ರ	ಸ ಮ ಗ ್ ರ |
ಸಮಯ	ಸ ಮ ಯ |
ಸಮಯದಲ್ಲಿ	ಸ ಮ ಯ ದ ಲ ್ ಲ ಿ |
ಸಮರ	ಸ ಮ ರ |
ಸಮರ್ಥ	ಸ ಮ ರ ್ ಥ |
ಸಮಸ್ತಿಪುರ್	ಸ ಮ ಸ ್ ತ ಿ ಪ ು ರ ್ |
ಸಮಸ್ಯೆ	ಸ ಮ ಸ ್ ಯ ೆ |
ಸಮಾಜ	ಸ ಮ ಾ ಜ |
ಸಮಾಜವಾದಿ	ಸ ಮ ಾ ಜ ವ ಾ ದ ಿ |
ಸಮಾಧಾನ	ಸ ಮ ಾ ಧ ಾ ನ |
ಸಮಾನ	ಸ ಮ ಾ ನ |
ಸಮಾರಂಭ	ಸ ಮ ಾ ರ ಂ ಭ |
ಸಮಾವೇಶ	ಸ ಮ ಾ ವ ೇ ಶ |
ಸಮಿತಿ	ಸ ಮ ಿ ತ ಿ |
ಸಮೀಪ	ಸ ಮ ೀ ಪ |
ಸಮುದಾಯ	ಸ ಮ ು ದ ಾ ಯ |
ಸಮುದ್ರ	ಸ ಮ ು ದ ್ ರ |
ಸಮೇತ	ಸ ಮ ೇ ತ |
ಸಮ್ಮಿಶ್ರ	ಸ ಮ ್ ಮ ಿ ಶ ್ ರ |
ಸಮ್ಮೇಳನ	ಸ ಮ ್ ಮ ೇ ಳ ನ |
ಸಯೈದ್	ಸ ಯ ೈ ದ ್ |
ಸರ	ಸ ರ |
ಸರಕಾರ	ಸ ರ ಕ ಾ ರ |
ಸರಗೂರು	ಸ ರ ಗ ೂ ರ ು |
ಸರಣಿ	ಸ ರ ಣ ಿ |
ಸರದಿ	ಸ ರ ದ ಿ |
ಸರಳ	ಸ ರ ಳ |
ಸರಿ	ಸ ರ ಿ |
ಸರಿಯಾಗಿ	ಸ ರ ಿ ಯ ಾ ಗ ಿ |
ಸರಿಯಾಗಿದೆ	ಸ ರ ಿ ಯ ಾ ಗ ಿ ದ ೆ |
ಸರ್ಕಾರ	ಸ ರ ್ ಕ ಾ ರ |
ಸರ್ದಾರ್	ಸ ರ ್ ದ ಾ ರ ್ |
ಸರ್ಫರೋಜ್	ಸ ರ ್ ಫ ರ ೋ ಜ ್ |
ಸರ್ವೇಪಲ್ಲಿ	ಸ ರ ್ ವ ೇ ಪ ಲ ್ ಲ ಿ |
ಸರ್ವೇಶ್ವರ್	ಸ ರ ್ ವ ೇ ಶ ್ ವ ರ ್ |
ಸಲ	ಸ ಲ |
ಸಲದ	ಸ ಲ ದ |
ಸಲಹೆ	ಸ ಲ ಹ ೆ |
ಸಲಾಮ್	ಸ ಲ ಾ ಮ ್ |
ಸಲೀಮ್	ಸ ಲ ೀ ಮ ್ |
ಸಲೀಲ್	ಸ ಲ ೀ ಲ ್ |
ಸಲೆಮ್	ಸ ಲ ೆ ಮ ್ |
ಸಲ್ಲಿಸು	ಸ ಲ ್ ಲ ಿ ಸ ು |
ಸವಣೂರು	ಸ ವ ಣ ೂ ರ ು |
ಸವದತ್ತಿ	ಸ ವ ದ ತ ್ ತ ಿ |
ಸವಾಲು	ಸ ವ ಾ ಲ ು |
ಸಸ್ಯ	ಸ ಸ ್ ಯ |
ಸಹ	ಸ ಹ |
ಸಹಕಾರ	ಸ ಹ ಕ ಾ ರ |
ಸಹಜ	ಸ ಹ ಜ |
ಸಹಾಯ	ಸ ಹ ಾ ಯ |
ಸಹಿತ	ಸ ಹ ಿ ತ |
ಸಹ್ಯ	ಸ ಹ ್ ಯ |
ಸಾಂಗ್	ಸ ಾ ಂ ಗ ್ |
ಸಾಂಗ್ಲಿಯಾನ	ಸ ಾ ಂ ಗ ್ ಲ ಿ ಯ ಾ ನ |
ಸಾಂಪ್ರದಾಯಿಕ	ಸ ಾ ಂ ಪ ್ ರ ದ ಾ ಯ ಿ ಕ |
ಸಾಂಸ್ಕೃತಿಕ	ಸ ಾ ಂ ಸ ್ ಕ ೃ ತ ಿ ಕ |
ಸಾಕಷ್ಟು	ಸ ಾ ಕ ಷ ್ ಟ ು |
ಸಾಕು	ಸ ಾ ಕ ು |
ಸಾಕ್ಷಿ	ಸ ಾ ಕ ್ ಷ ಿ |
ಸಾಗರ	ಸ ಾ ಗ ರ |
ಸಾಗು	ಸ ಾ ಗ ು |
ಸಾತನೂರು	ಸ ಾ ತ ನ ೂ ರ ು |
ಸಾಧತ್	ಸ ಾ ಧ ತ ್ |
ಸಾಧನ	ಸ ಾ ಧ ನ |
ಸಾಧನೆ	ಸ ಾ ಧ ನ ೆ |
ಸಾಧಾರಣ	ಸ ಾ ಧ ಾ ರ ಣ |
ಸಾಧಿಸಬಹುದು	ಸ ಾ ಧ ಿ ಸ ಬ ಹ ು ದ ು |
ಸಾಧಿಸು	ಸ ಾ ಧ ಿ ಸ ು |
ಸಾಧ್ಯ	ಸ ಾ ಧ ್ ಯ |
ಸಾಧ್ಯತೆ	ಸ ಾ ಧ ್ ಯ ತ ೆ |
ಸಾನಿಯಾ	ಸ ಾ ನ ಿ ಯ ಾ |
ಸಾಬಿ	ಸ ಾ ಬ ಿ |
ಸಾಮರ್ಥ್ಯ	ಸ ಾ ಮ ರ ್ ಥ ್ ಯ |
ಸಾಮಾಜಿಕ	ಸ ಾ ಮ ಾ ಜ ಿ ಕ |
ಸಾಮಾನ್ಯ	ಸ ಾ ಮ ಾ ನ ್ ಯ |
ಸಾಮಾನ್ಯವಾಗಿ	ಸ ಾ ಮ ಾ ನ ್ ಯ ವ ಾ ಗ ಿ |
ಸಾಯಂಕಾಲ	ಸ ಾ ಯ ಂ ಕ ಾ ಲ |
ಸಾಯು	ಸ ಾ ಯ ು |
ಸಾರಿ	ಸ ಾ ರ ಿ |
ಸಾರು	ಸ ಾ ರ ು |
ಸಾರ್ವಜನಿಕ	ಸ ಾ ರ ್ ವ ಜ ನ ಿ ಕ |
ಸಾಲ	ಸ ಾ ಲ |
ಸಾಲಕ್ಕಿಂತ	ಸ ಾ ಲ ಕ ್ ಕ ಿ ಂ ತ |
ಸಾಲದು	ಸ ಾ ಲ ದ ು |
ಸಾಲಲ್ಲ	ಸ ಾ ಲ ಲ ್ ಲ |
ಸಾಲು	ಸ ಾ ಲ ು |
ಸಾವಿದ್ದರೂ	ಸ ಾ ವ ಿ ದ ್ ದ ರ ೂ |
ಸಾವಿರ	ಸ ಾ ವ ಿ ರ |
ಸಾವಿಲ್ಲ	ಸ ಾ ವ ಿ ಲ ್ ಲ |
ಸಾವು	ಸ ಾ ವ ು |
ಸಾಹಸ	ಸ ಾ ಹ ಸ |
ಸಾಹಿತಿ	ಸ ಾ ಹ ಿ ತ ಿ |
ಸಾಹಿತ್ಯ	ಸ ಾ ಹ ಿ ತ ್ ಯ |
ಸಾಹಿಬಸಾದ್	ಸ ಾ ಹ ಿ ಬ ಸ ಾ ದ ್ |
ಸಾಹಿಬ್	ಸ ಾ ಹ ಿ ಬ ್ |
ಸಿ	ಸ ಿ |
ಸಿಂಗಾರಾರ್ಯ	ಸ ಿ ಂ ಗ ಾ ರ ಾ ರ ್ ಯ |
ಸಿಂಗ್	ಸ ಿ ಂ ಗ ್ |
ಸಿಂಧಗಿ	ಸ ಿ ಂ ಧ ಗ ಿ |
ಸಿಂಧೂರ್	ಸ ಿ ಂ ಧ ೂ ರ ್ |
ಸಿಂಹ	ಸ ಿ ಂ ಹ |
ಸಿಎನ್	ಸ ಿ ಎ ನ ್ |
ಸಿಗು	ಸ ಿ ಗ ು |
ಸಿಗುತ್ತದೆ	ಸ ಿ ಗ ು ತ ್ ತ ದ ೆ |
ಸಿಗುತ್ತವೆ	ಸ ಿ ಗ ು ತ ್ ತ ವ ೆ |
ಸಿಟ್ಟು	ಸ ಿ ಟ ್ ಟ ು |
ಸಿಡಿ	ಸ ಿ ಡ ಿ |
ಸಿದ್ದಪ್ಪ	ಸ ಿ ದ ್ ದ ಪ ್ ಪ |
ಸಿದ್ದಲಘಟ್ಟ	ಸ ಿ ದ ್ ದ ಲ ಘ ಟ ್ ಟ |
ಸಿದ್ದವನಳ್ಳಿ	ಸ ಿ ದ ್ ದ ವ ನ ಳ ್ ಳ ಿ |
ಸಿದ್ಧ	ಸ ಿ ದ ್ ಧ |
ಸಿದ್ಧಾಂತ	ಸ ಿ ದ ್ ಧ ಾ ಂ ತ |
ಸಿದ್ಧಾಪುರ	ಸ ಿ ದ ್ ಧ ಾ ಪ ು ರ |
ಸಿದ್ಧು	ಸ ಿ ದ ್ ಧ ು |
ಸಿನಿಮಾ	ಸ ಿ ನ ಿ ಮ ಾ |
ಸಿಮಡೆಗಾ	ಸ ಿ ಮ ಡ ೆ ಗ ಾ |
ಸಿರಾಜ್	ಸ ಿ ರ ಾ ಜ ್ |
ಸಿರುಗುಪ್ಪ	ಸ ಿ ರ ು ಗ ು ಪ ್ ಪ |
ಸಿಲ್	ಸ ಿ ಲ ್ |
ಸಿಲ್ವಾ	ಸ ಿ ಲ ್ ವ ಾ |
ಸಿವಿ	ಸ ಿ ವ ಿ |
ಸೀತಾಪುರ್	ಸ ೀ ತ ಾ ಪ ು ರ ್ |
ಸೀತಾರಾಂ	ಸ ೀ ತ ಾ ರ ಾ ಂ |
ಸೀತಾರಾಮಯ್ಯ	ಸ ೀ ತ ಾ ರ ಾ ಮ ಯ ್ ಯ |
ಸುಂಕ	ಸ ು ಂ ಕ |
ಸುಂದರ	ಸ ು ಂ ದ ರ |
ಸುಂದರವಾಗಿದೆ	ಸ ು ಂ ದ ರ ವ ಾ ಗ ಿ ದ ೆ |
ಸುಂದರ್	ಸ ು ಂ ದ ರ ್ |
ಸುಕಿಯಾ	ಸ ು ಕ ಿ ಯ ಾ |
ಸುಖ	ಸ ು ಖ |
ಸುಗಡ್	ಸ ು ಗ ಡ ್ |
ಸುಗ್ಗಿ	ಸ ು ಗ ್ ಗ ಿ |
ಸುಗ್ಗಿಯ	ಸ ು ಗ ್ ಗ ಿ ಯ |
ಸುಚಿ	ಸ ು ಚ ಿ |
ಸುಜಾತ್	ಸ ು ಜ ಾ ತ ್ |
ಸುತ್ತ	ಸ ು ತ ್ ತ |
ಸುತ್ತಲೂ	ಸ ು ತ ್ ತ ಲ ೂ |
ಸುತ್ತು	ಸ ು ತ ್ ತ ು |
ಸುತ್ತುತ್ತಿದ್ದರು	ಸ ು ತ ್ ತ ು ತ ್ ತ ಿ ದ ್ ದ ರ ು |
ಸುದ್ದಿ	ಸ ು ದ ್ ದ ಿ |
ಸುದ್ದಿಗಾರ	ಸ ು ದ ್ ದ ಿ ಗ ಾ ರ |
ಸುದ್ದಿಯನ್ನು	ಸ ು ದ ್ ದ ಿ ಯ ನ ್ ನ ು |
ಸುಧಾ	ಸ ು ಧ ಾ |
ಸುಧಾರಣೆ	ಸ ು ಧ ಾ ರ ಣ ೆ |
ಸುಧಾರಾಣಿ	ಸ ು ಧ ಾ ರ ಾ ಣ ಿ |
ಸುನೀಲ್	ಸ ು ನ ೀ ಲ ್ |
ಸುಪೌಲ್	ಸ ು ಪ ೌ ಲ ್ |
ಸುಬ್ರಹ್ಮಣ್ಯ	ಸ ು ಬ ್ ರ ಹ ್ ಮ ಣ ್ ಯ |
ಸುಭಾಷ್	ಸ ು ಭ ಾ ಷ ್ |
ಸುಮಾರು	ಸ ು ಮ ಾ ರ ು |
ಸುಮಿತ್ರಾನಂದ	ಸ ು ಮ ಿ ತ ್ ರ ಾ ನ ಂ ದ |
ಸುಮ್ಮನೆ	ಸ ು ಮ ್ ಮ ನ ೆ |
ಸುರಿಯುತ್ತಿತ್ತು	ಸ ು ರ ಿ ಯ ು ತ ್ ತ ಿ ತ ್ ತ ು |
ಸುರ್ಜಿತ್	ಸ ು ರ ್ ಜ ಿ ತ ್ |
ಸುಲಭ	ಸ ು ಲ ಭ |
ಸುಲ್ತಾನ್	ಸ ು ಲ ್ ತ ಾ ನ ್ |
ಸುಳ್ಳು	ಸ ು ಳ ್ ಳ ು |
ಸೂಕ್ತ	ಸ ೂ ಕ ್ ತ |
ಸೂಕ್ಷ್ಮ	ಸ ೂ ಕ ್ ಷ ್ ಮ |
ಸೂಚನೆ	ಸ ೂ ಚ ನ ೆ |
ಸೂಚಿಸು	ಸ ೂ ಚ ಿ ಸ ು |
ಸೂಚಿಸುತ್ತವೆ	ಸ ೂ ಚ ಿ ಸ ು ತ ್ ತ ವ ೆ |
ಸೂತ್ರ	ಸ ೂ ತ ್ ರ |
ಸೂರ್ಯ	ಸ ೂ ರ ್ ಯ |
ಸೂರ್ಯಕಾಂತ್	ಸ ೂ ರ ್ ಯ ಕ ಾ ಂ ತ ್ |
ಸೂಳ್ಯ	ಸ ೂ ಳ ್ ಯ |
ಸೃಷ್ಟಿ	ಸ ೃ ಷ ್ ಟ ಿ |
ಸೆಪ್ಟಂಬರ್	ಸ ೆ ಪ ್ ಟ ಂ ಬ ರ ್ |
ಸೆಲೀನಾ	ಸ ೆ ಲ ೀ ನ ಾ |
ಸೆಳೆ	ಸ ೆ ಳ ೆ |
ಸೇಡಂ	ಸ ೇ ಡ ಂ |
ಸೇನಾಪತಿ	ಸ ೇ ನ ಾ ಪ ತ ಿ |
ಸೇನ್	ಸ ೇ ನ ್ |
ಸೇಬು	ಸ ೇ ಬ ು |
ಸೇರಿಕೊಳ್ಳುವುದು	ಸ ೇ ರ ಿ ಕ ೊ ಳ ್ ಳ ು ವ ು ದ ು |
ಸೇರಿದವರು	ಸ ೇ ರ ಿ ದ ವ ರ ು |
ಸೇರು	ಸ ೇ ರ ು |
ಸೇವಿಸುವುದರಿಂದ	ಸ ೇ ವ ಿ ಸ ು ವ ು ದ ರ ಿ ಂ ದ |
ಸೇವೆ	ಸ ೇ ವ ೆ |
ಸೈಕಲ್ಲುಗಳು	ಸ ೈ ಕ ಲ ್ ಲ ು ಗ ಳ ು |
ಸೈಫ್	ಸ ೈ ಫ ್ |
ಸೈಯೆದ್	ಸ ೈ ಯ ೆ ದ ್ |
ಸೊಂಟ	ಸ ೊ ಂ ಟ |
ಸೊಂಟಕ್ಕೆ	ಸ ೊ ಂ ಟ ಕ ್ ಕ ೆ |
ಸೊನ್ನೆ	ಸ ೊ ನ ್ ನ ೆ |
ಸೊರಬ	ಸ ೊ ರ ಬ |
ಸೊಸೆ	ಸ ೊ ಸ ೆ |
ಸೋನಿಯಾ	ಸ ೋ ನ ಿ ಯ ಾ |
ಸೋನು	ಸ ೋ ನ ು |
ಸೋಪೋರ್	ಸ ೋ ಪ ೋ ರ ್ |
ಸೋಮನಾಥಪುರ	ಸ ೋ ಮ ನ ಾ ಥ ಪ ು ರ |
ಸೋಮನಾಥ್	ಸ ೋ ಮ ನ ಾ ಥ ್ |
ಸೋಮಯಾಜಿ	ಸ ೋ ಮ ಯ ಾ ಜ ಿ |
ಸೋಮವಾರ	ಸ ೋ ಮ ವ ಾ ರ |
ಸೋಮಶೇಖರ	ಸ ೋ ಮ ಶ ೇ ಖ ರ |
ಸೋಮಾರಪೇಟೆ	ಸ ೋ ಮ ಾ ರ ಪ ೇ ಟ ೆ |
ಸೋಮೇಶ್ವರ	ಸ ೋ ಮ ೇ ಶ ್ ವ ರ |
ಸೋಲನ್	ಸ ೋ ಲ ನ ್ |
ಸೋಲು	ಸ ೋ ಲ ು |
ಸೋಲ್	ಸ ೋ ಲ ್ |
ಸೋಸು	ಸ ೋ ಸ ು |
ಸೋಹಿಲ್	ಸ ೋ ಹ ಿ ಲ ್ |
ಸೌಂದರ್ಯ	ಸ ೌ ಂ ದ ರ ್ ಯ |
ಸೌಟು	ಸ ೌ ಟ ು |
ಸೌರವ್	ಸ ೌ ರ ವ ್ |
ಸೌಲಭ್ಯ	ಸ ೌ ಲ ಭ ್ ಯ |
ಸ್ಟೀಫನ್	ಸ ್ ಟ ೀ ಫ ನ ್ |
ಸ್ಟೀವ್	ಸ ್ ಟ ೀ ವ ್ |
ಸ್ತ್ರೀ	ಸ ್ ತ ್ ರ ೀ |
ಸ್ಥಳ	ಸ ್ ಥ ಳ |
ಸ್ಥಳವನ್ನು	ಸ ್ ಥ ಳ ವ ನ ್ ನ ು |
ಸ್ಥಳೀಯ	ಸ ್ ಥ ಳ ೀ ಯ |
ಸ್ಥಾನ	ಸ ್ ಥ ಾ ನ |
ಸ್ಥಾಪಿಸು	ಸ ್ ಥ ಾ ಪ ಿ ಸ ು |
ಸ್ಥಿತಿ	ಸ ್ ಥ ಿ ತ ಿ |
ಸ್ನಾನ	ಸ ್ ನ ಾ ನ |
ಸ್ನೇಹಿತರ	ಸ ್ ನ ೇ ಹ ಿ ತ ರ |
ಸ್ಪರ್ಧಿಸು	ಸ ್ ಪ ರ ್ ಧ ಿ ಸ ು |
ಸ್ಪರ್ಧೆ	ಸ ್ ಪ ರ ್ ಧ ೆ |
ಸ್ಪರ್ಧೆಯಲ್ಲಿ	ಸ ್ ಪ ರ ್ ಧ ೆ ಯ ಲ ್ ಲ ಿ |
ಸ್ಪಷ್ಟ	ಸ ್ ಪ ಷ ್ ಟ |
ಸ್ಲೇ	ಸ ್ ಲ ೇ |
ಸ್ವಂತ	ಸ ್ ವ ಂ ತ |
ಸ್ವಚ್ಛ	ಸ ್ ವ ಚ ್ ಛ |
ಸ್ವತಂತ್ರ	ಸ ್ ವ ತ ಂ ತ ್ ರ |
ಸ್ವತಃ	ಸ ್ ವ ತ ಃ |
ಸ್ವಪ್ನ	ಸ ್ ವ ಪ ್ ನ |
ಸ್ವಭಾವ	ಸ ್ ವ ಭ ಾ ವ |
ಸ್ವಯಂ	ಸ ್ ವ ಯ ಂ |
ಸ್ವರೂಪ	ಸ ್ ವ ರ ೂ ಪ |
ಸ್ವಲ್ಪ	ಸ ್ ವ ಲ ್ ಪ |
ಸ್ವಾತಂತ್ರ್ಯ	ಸ ್ ವ ಾ ತ ಂ ತ ್ ರ ್ ಯ |
ಸ್ವಾಮಿ	ಸ ್ ವ ಾ ಮ ಿ |
ಸ್ವೀಕರಿಸು	ಸ ್ ವ ೀ ಕ ರ ಿ ಸ ು |
ಹಂತ	ಹ ಂ ತ |
ಹಂಪಿ	ಹ ಂ ಪ ಿ |
ಹಕ್	ಹ ಕ ್ |
ಹಕ್ಕ	ಹ ಕ ್ ಕ |
ಹಕ್ಕಿ	ಹ ಕ ್ ಕ ಿ |
ಹಕ್ಕು	ಹ ಕ ್ ಕ ು |
ಹಗಲು	ಹ ಗ ಲ ು |
ಹಗ್ಗ	ಹ ಗ ್ ಗ |
ಹಚ್ಚಹಸಿರಾಗಿದೆ	ಹ ಚ ್ ಚ ಹ ಸ ಿ ರ ಾ ಗ ಿ ದ ೆ |
ಹಚ್ಚು	ಹ ಚ ್ ಚ ು |
ಹಜಾರಿ	ಹ ಜ ಾ ರ ಿ |
ಹಜಾರೀಬಾಗ್	ಹ ಜ ಾ ರ ೀ ಬ ಾ ಗ ್ |
ಹಣ	ಹ ಣ |
ಹಣಕಾಸು	ಹ ಣ ಕ ಾ ಸ ು |
ಹಣವನ್ನೆಲ್ಲ	ಹ ಣ ವ ನ ್ ನ ೆ ಲ ್ ಲ |
ಹಣೆ	ಹ ಣ ೆ |
ಹಣ್ಣನ್ನು	ಹ ಣ ್ ಣ ನ ್ ನ ು |
ಹಣ್ಣು	ಹ ಣ ್ ಣ ು |
ಹತ್ತನೆಯ	ಹ ತ ್ ತ ನ ೆ ಯ |
ಹತ್ತಲು	ಹ ತ ್ ತ ಲ ು |
ಹತ್ತಿರ	ಹ ತ ್ ತ ಿ ರ |
ಹತ್ತಿರವೇ	ಹ ತ ್ ತ ಿ ರ ವ ೇ |
ಹತ್ತು	ಹ ತ ್ ತ ು |
ಹತ್ತುವಾಗ	ಹ ತ ್ ತ ು ವ ಾ ಗ |
ಹತ್ತೊಂಬತ್ತು	ಹ ತ ್ ತ ೊ ಂ ಬ ತ ್ ತ ು |
ಹದಿನಾರು	ಹ ದ ಿ ನ ಾ ರ ು |
ಹದಿನಾಲ್ಕು	ಹ ದ ಿ ನ ಾ ಲ ್ ಕ ು |
ಹದಿನೆಂಟು	ಹ ದ ಿ ನ ೆ ಂ ಟ ು |
ಹದಿನೇಳು	ಹ ದ ಿ ನ ೇ ಳ ು |
ಹದಿನೈದು	ಹ ದ ಿ ನ ೈ ದ ು |
ಹದಿಮೂರು	ಹ ದ ಿ ಮ ೂ ರ ು |
ಹನಕೆರೆ	ಹ ನ ಕ ೆ ರ ೆ |
ಹನಗುಂದ	ಹ ನ ಗ ು ಂ ದ |
ಹನಿ	ಹ ನ ಿ |
ಹನುಮಂತಯ್ಯ	ಹ ನ ು ಮ ಂ ತ ಯ ್ ಯ |
ಹನುಮಾನ್	ಹ ನ ು ಮ ಾ ನ ್ |
ಹನ್ನೆರಡು	ಹ ನ ್ ನ ೆ ರ ಡ ು |
ಹನ್ನೊಂದು	ಹ ನ ್ ನ ೊ ಂ ದ ು |
ಹನ್ಸಿ	ಹ ನ ್ ಸ ಿ |
ಹಬ್ಬ	ಹ ಬ ್ ಬ |
ಹಬ್ಬಕ್ಕೆ	ಹ ಬ ್ ಬ ಕ ್ ಕ ೆ |
ಹಮೀರ್	ಹ ಮ ೀ ರ ್ |
ಹರದನಹಳ್ಲಿ	ಹ ರ ದ ನ ಹ ಳ ್ ಲ ಿ |
ಹರದೊಯಿ	ಹ ರ ದ ೊ ಯ ಿ |
ಹರಪನಹಳ್ಳಿ	ಹ ರ ಪ ನ ಹ ಳ ್ ಳ ಿ |
ಹರಿ	ಹ ರ ಿ |
ಹರಿತವಾಗಿದೆ	ಹ ರ ಿ ತ ವ ಾ ಗ ಿ ದ ೆ |
ಹರಿದ್ವಾರ್	ಹ ರ ಿ ದ ್ ವ ಾ ರ ್ |
ಹರಿಹರ	ಹ ರ ಿ ಹ ರ |
ಹರೀಷ್	ಹ ರ ೀ ಷ ್ |
ಹರ್	ಹ ರ ್ |
ಹರ್ಷಿಲ್	ಹ ರ ್ ಷ ಿ ಲ ್ |
ಹಲಗೂರು	ಹ ಲ ಗ ೂ ರ ು |
ಹಲವಾರು	ಹ ಲ ವ ಾ ರ ು |
ಹಲ್ದಿಯಾ	ಹ ಲ ್ ದ ಿ ಯ ಾ |
ಹಲ್ದ್ವಾನೀ	ಹ ಲ ್ ದ ್ ವ ಾ ನ ೀ |
ಹಲ್ಲಿ	ಹ ಲ ್ ಲ ಿ |
ಹಲ್ಲು	ಹ ಲ ್ ಲ ು |
ಹಲ್ಲೇಗೆರೆ	ಹ ಲ ್ ಲ ೇ ಗ ೆ ರ ೆ |
ಹಳದಿ	ಹ ಳ ದ ಿ |
ಹಳೆಯ	ಹ ಳ ೆ ಯ |
ಹಳೇ	ಹ ಳ ೇ |
ಹಳೇಬೀಡು	ಹ ಳ ೇ ಬ ೀ ಡ ು |
ಹಳ್ಳಿ	ಹ ಳ ್ ಳ ಿ |
ಹಳ್ಳಿಗಳಲ್ಲಿ	ಹ ಳ ್ ಳ ಿ ಗ ಳ ಲ ್ ಲ ಿ |
ಹಶ್ಮಿ	ಹ ಶ ್ ಮ ಿ |
ಹಸನ್	ಹ ಸ ನ ್ |
ಹಸಿರು	ಹ ಸ ಿ ರ ು |
ಹಸು	ಹ ಸ ು |
ಹಸ್ತ	ಹ ಸ ್ ತ |
ಹಸ್ತಕ್ಕಿಂತ	ಹ ಸ ್ ತ ಕ ್ ಕ ಿ ಂ ತ |
ಹಸ್ತವು	ಹ ಸ ್ ತ ವ ು |
ಹಸ್ತಾಂತರ	ಹ ಸ ್ ತ ಾ ಂ ತ ರ |
ಹಾಕದಿದ್ದರೆ	ಹ ಾ ಕ ದ ಿ ದ ್ ದ ರ ೆ |
ಹಾಕಿಕೊಳ್ಳುತ್ತಿದ್ದರು	ಹ ಾ ಕ ಿ ಕ ೊ ಳ ್ ಳ ು ತ ್ ತ ಿ ದ ್ ದ ರ ು |
ಹಾಕಿದರೆ	ಹ ಾ ಕ ಿ ದ ರ ೆ |
ಹಾಕಿರುತ್ತಾರೆ	ಹ ಾ ಕ ಿ ರ ು ತ ್ ತ ಾ ರ ೆ |
ಹಾಕು	ಹ ಾ ಕ ು |
ಹಾಗಾದ್ದರಿಂದ	ಹ ಾ ಗ ಾ ದ ್ ದ ರ ಿ ಂ ದ |
ಹಾಗು	ಹ ಾ ಗ ು |
ಹಾಗೂ	ಹ ಾ ಗ ೂ |
ಹಾಗೆ	ಹ ಾ ಗ ೆ |
ಹಾಜೀಪುರ್	ಹ ಾ ಜ ೀ ಪ ು ರ ್ |
ಹಾಡು	ಹ ಾ ಡ ು |
ಹಾಡುವುದನ್ನು	ಹ ಾ ಡ ು ವ ು ದ ನ ್ ನ ು |
ಹಾದಿ	ಹ ಾ ದ ಿ |
ಹಾನಗಲ್	ಹ ಾ ನ ಗ ಲ ್ |
ಹಾನಗಲ್ಲು	ಹ ಾ ನ ಗ ಲ ್ ಲ ು |
ಹಾಪುಡ್	ಹ ಾ ಪ ು ಡ ್ |
ಹಾಫ್	ಹ ಾ ಫ ್ |
ಹಾರು	ಹ ಾ ರ ು |
ಹಾರ್ಡ್ಲಿ	ಹ ಾ ರ ್ ಡ ್ ಲ ಿ |
ಹಾಲು	ಹ ಾ ಲ ು |
ಹಾವು	ಹ ಾ ವ ು |
ಹಾವೇರಿ	ಹ ಾ ವ ೇ ರ ಿ |
ಹಾಸನ	ಹ ಾ ಸ ನ |
ಹಾಸನ್	ಹ ಾ ಸ ನ ್ |
ಹಾಸಿಗೆ	ಹ ಾ ಸ ಿ ಗ ೆ |
ಹಾಸು	ಹ ಾ ಸ ು |
ಹಾಸ್ಯ	ಹ ಾ ಸ ್ ಯ |
ಹಿಂದಿ	ಹ ಿ ಂ ದ ಿ |
ಹಿಂದಿನ	ಹ ಿ ಂ ದ ಿ ನ |
ಹಿಂದುಳಿದ	ಹ ಿ ಂ ದ ು ಳ ಿ ದ |
ಹಿಂದೂ	ಹ ಿ ಂ ದ ೂ |
ಹಿಂದೆ	ಹ ಿ ಂ ದ ೆ |
ಹಿಡಿ	ಹ ಿ ಡ ಿ |
ಹಿತ	ಹ ಿ ತ |
ಹಿತವಾಗಿದೆ	ಹ ಿ ತ ವ ಾ ಗ ಿ ದ ೆ |
ಹಿನ್ನೆಲೆ	ಹ ಿ ನ ್ ನ ೆ ಲ ೆ |
ಹಿಮೇಶ್	ಹ ಿ ಮ ೇ ಶ ್ |
ಹಿಮ್ಮಡಿ	ಹ ಿ ಮ ್ ಮ ಡ ಿ |
ಹಿರಾನಂದ್	ಹ ಿ ರ ಾ ನ ಂ ದ ್ |
ಹಿರಿಯ	ಹ ಿ ರ ಿ ಯ |
ಹಿರಿಯೂರು	ಹ ಿ ರ ಿ ಯ ೂ ರ ು |
ಹಿರೆಕೇರೂರು	ಹ ಿ ರ ೆ ಕ ೇ ರ ೂ ರ ು |
ಹಿರ್ವಾಣಿ	ಹ ಿ ರ ್ ವ ಾ ಣ ಿ |
ಹಿಸಾರ್	ಹ ಿ ಸ ಾ ರ ್ |
ಹೀಗೆ	ಹ ೀ ಗ ೆ |
ಹುಂಜ	ಹ ು ಂ ಜ |
ಹುಕುಮ್	ಹ ು ಕ ು ಮ ್ |
ಹುಕ್ಕೇರಿ	ಹ ು ಕ ್ ಕ ೇ ರ ಿ |
ಹುಚ್ಚ	ಹ ು ಚ ್ ಚ |
ಹುಟ್ಟು	ಹ ು ಟ ್ ಟ ು |
ಹುಟ್ಟುಹಬ್ಬಕ್ಕೆ	ಹ ು ಟ ್ ಟ ು ಹ ಬ ್ ಬ ಕ ್ ಕ ೆ |
ಹುಡುಕಿದರೆ	ಹ ು ಡ ು ಕ ಿ ದ ರ ೆ |
ಹುಡುಕು	ಹ ು ಡ ು ಕ ು |
ಹುಡುಗ	ಹ ು ಡ ು ಗ |
ಹುಡುಗಿ	ಹ ು ಡ ು ಗ ಿ |
ಹುಡುಗಿಯ	ಹ ು ಡ ು ಗ ಿ ಯ |
ಹುಣಸೂರು	ಹ ು ಣ ಸ ೂ ರ ು |
ಹುತ್ತ	ಹ ು ತ ್ ತ |
ಹುತ್ತವನ್ನು	ಹ ು ತ ್ ತ ವ ನ ್ ನ ು |
ಹುದ್ದೆ	ಹ ು ದ ್ ದ ೆ |
ಹುಬ್ಬಳ್ಳಿ	ಹ ು ಬ ್ ಬ ಳ ್ ಳ ಿ |
ಹುಬ್ಬು	ಹ ು ಬ ್ ಬ ು |
ಹುಬ್ಬುಗಳು	ಹ ು ಬ ್ ಬ ು ಗ ಳ ು |
ಹುಮ್ಮಸ್ಸು	ಹ ು ಮ ್ ಮ ಸ ್ ಸ ು |
ಹುಲಿ	ಹ ು ಲ ಿ |
ಹುಲಿಗಳ	ಹ ು ಲ ಿ ಗ ಳ |
ಹುಲಿವಾನ	ಹ ು ಲ ಿ ವ ಾ ನ |
ಹುಲ್ಲು	ಹ ು ಲ ್ ಲ ು |
ಹುಷಾರಾಗಿರು	ಹ ು ಷ ಾ ರ ಾ ಗ ಿ ರ ು |
ಹುಸೇನ್	ಹ ು ಸ ೇ ನ ್ |
ಹುಸ್ಸೈನ್	ಹ ು ಸ ್ ಸ ೈ ನ ್ |
ಹೂ	ಹ ೂ |
ಹೂಗಳು	ಹ ೂ ಗ ಳ ು |
ಹೂಪರ್	ಹ ೂ ಪ ರ ್ |
ಹೂವು	ಹ ೂ ವ ು |
ಹೃದಯ	ಹ ೃ ದ ಯ |
ಹೃದಯಘಾತವಾಯಿತು	ಹ ೃ ದ ಯ ಘ ಾ ತ ವ ಾ ಯ ಿ ತ ು |
ಹೆಂಗಸು	ಹ ೆ ಂ ಗ ಸ ು |
ಹೆಂಡತಿ	ಹ ೆ ಂ ಡ ತ ಿ |
ಹೆಗಡೆ	ಹ ೆ ಗ ಡ ೆ |
ಹೆಚ್	ಹ ೆ ಚ ್ |
ಹೆಚ್ಚಲು	ಹ ೆ ಚ ್ ಚ ಲ ು |
ಹೆಚ್ಚಾಗಿ	ಹ ೆ ಚ ್ ಚ ಾ ಗ ಿ |
ಹೆಚ್ಚಾಗಿದೆ	ಹ ೆ ಚ ್ ಚ ಾ ಗ ಿ ದ ೆ |
ಹೆಚ್ಚಾಗಿರುತ್ತದೆ	ಹ ೆ ಚ ್ ಚ ಾ ಗ ಿ ರ ು ತ ್ ತ ದ ೆ |
ಹೆಚ್ಚಿರುವುದರಿಂದ	ಹ ೆ ಚ ್ ಚ ಿ ರ ು ವ ು ದ ರ ಿ ಂ ದ |
ಹೆಚ್ಚಿಸಬೇಡ	ಹ ೆ ಚ ್ ಚ ಿ ಸ ಬ ೇ ಡ |
ಹೆಚ್ಚಿಸಿರಿ	ಹ ೆ ಚ ್ ಚ ಿ ಸ ಿ ರ ಿ |
ಹೆಚ್ಚಿಸು	ಹ ೆ ಚ ್ ಚ ಿ ಸ ು |
ಹೆಚ್ಚು	ಹ ೆ ಚ ್ ಚ ು |
ಹೆಚ್ಟಿ	ಹ ೆ ಚ ್ ಟ ಿ |
ಹೆಚ್ಡಿ	ಹ ೆ ಚ ್ ಡ ಿ |
ಹೆಜ್ಜೆ	ಹ ೆ ಜ ್ ಜ ೆ |
ಹೆಡ್ಡ	ಹ ೆ ಡ ್ ಡ |
ಹೆಣ್ಣು	ಹ ೆ ಣ ್ ಣ ು |
ಹೆಣ್ಣುಮಕ್ಕಳು	ಹ ೆ ಣ ್ ಣ ು ಮ ಕ ್ ಕ ಳ ು |
ಹೆಬ್ಬೆರಳು	ಹ ೆ ಬ ್ ಬ ೆ ರ ಳ ು |
ಹೆಮ್ಮೆ	ಹ ೆ ಮ ್ ಮ ೆ |
ಹೆಸರು	ಹ ೆ ಸ ರ ು |
ಹೇಗಾದ್ರೂ	ಹ ೇ ಗ ಾ ದ ್ ರ ೂ |
ಹೇಗೆ	ಹ ೇ ಗ ೆ |
ಹೇಮಂತ	ಹ ೇ ಮ ಂ ತ |
ಹೇಳಬೇಡ	ಹ ೇ ಳ ಬ ೇ ಡ |
ಹೇಳಿ	ಹ ೇ ಳ ಿ |
ಹೇಳಿಕೆ	ಹ ೇ ಳ ಿ ಕ ೆ |
ಹೇಳು	ಹ ೇ ಳ ು |
ಹೇಳುತ್ತಾರೆ	ಹ ೇ ಳ ು ತ ್ ತ ಾ ರ ೆ |
ಹೇಳುವುದಾದರೆ	ಹ ೇ ಳ ು ವ ು ದ ಾ ದ ರ ೆ |
ಹೈದಾರಾಬಾದ್	ಹ ೈ ದ ಾ ರ ಾ ಬ ಾ ದ ್ |
ಹೊಂದಾಣಿಕೆ	ಹ ೊ ಂ ದ ಾ ಣ ಿ ಕ ೆ |
ಹೊಂದಿದೆ	ಹ ೊ ಂ ದ ಿ ದ ೆ |
ಹೊಂದು	ಹ ೊ ಂ ದ ು |
ಹೊಕ್ಕಳು	ಹ ೊ ಕ ್ ಕ ಳ ು |
ಹೊಗಳು	ಹ ೊ ಗ ಳ ು |
ಹೊಗಳುವವರನ್ನು	ಹ ೊ ಗ ಳ ು ವ ವ ರ ನ ್ ನ ು |
ಹೊಟ್ಟೆ	ಹ ೊ ಟ ್ ಟ ೆ |
ಹೊಟ್ಟೆಗೆ	ಹ ೊ ಟ ್ ಟ ೆ ಗ ೆ |
ಹೊಡಿ	ಹ ೊ ಡ ಿ |
ಹೊಡೆ	ಹ ೊ ಡ ೆ |
ಹೊಡೆಯಬೇಡ	ಹ ೊ ಡ ೆ ಯ ಬ ೇ ಡ |
ಹೊಡೆಯಿರಿ	ಹ ೊ ಡ ೆ ಯ ಿ ರ ಿ |
ಹೊಣೆ	ಹ ೊ ಣ ೆ |
ಹೊತ್ತಿಗೆ	ಹ ೊ ತ ್ ತ ಿ ಗ ೆ |
ಹೊತ್ತಿನಲ್ಲಿ	ಹ ೊ ತ ್ ತ ಿ ನ ಲ ್ ಲ ಿ |
ಹೊತ್ತಿನಿಂದ	ಹ ೊ ತ ್ ತ ಿ ನ ಿ ಂ ದ |
ಹೊತ್ತು	ಹ ೊ ತ ್ ತ ು |
ಹೊನ್ನಮ್ಮ	ಹ ೊ ನ ್ ನ ಮ ್ ಮ |
ಹೊನ್ನಹಳ್ಳಿ	ಹ ೊ ನ ್ ನ ಹ ಳ ್ ಳ ಿ |
ಹೊನ್ನಾವರ	ಹ ೊ ನ ್ ನ ಾ ವ ರ |
ಹೊರಗೆ	ಹ ೊ ರ ಗ ೆ |
ಹೊರಟಿದ್ದರೆ	ಹ ೊ ರ ಟ ಿ ದ ್ ದ ರ ೆ |
ಹೊರಡು	ಹ ೊ ರ ಡ ು |
ಹೊರತು	ಹ ೊ ರ ತ ು |
ಹೊಲ	ಹ ೊ ಲ |
ಹೊಲಿ	ಹ ೊ ಲ ಿ |
ಹೊಳಲ್ಕೆರೆ	ಹ ೊ ಳ ಲ ್ ಕ ೆ ರ ೆ |
ಹೊಳೆ	ಹ ೊ ಳ ೆ |
ಹೊಳೆನರಸೀಪುರ	ಹ ೊ ಳ ೆ ನ ರ ಸ ೀ ಪ ು ರ |
ಹೊಳೆಯ	ಹ ೊ ಳ ೆ ಯ |
ಹೊಳ್ಳೆ	ಹ ೊ ಳ ್ ಳ ೆ |
ಹೊಶಿಯಾರ್	ಹ ೊ ಶ ಿ ಯ ಾ ರ ್ |
ಹೊಸ	ಹ ೊ ಸ |
ಹೊಸದು	ಹ ೊ ಸ ದ ು |
ಹೊಸದುರ್ಗ	ಹ ೊ ಸ ದ ು ರ ್ ಗ |
ಹೊಸನಗರ	ಹ ೊ ಸ ನ ಗ ರ |
ಹೋಗಬೇಡ	ಹ ೋ ಗ ಬ ೇ ಡ |
ಹೋಗಿ	ಹ ೋ ಗ ಿ |
ಹೋಗು	ಹ ೋ ಗ ು |
ಹೋಗುತ್ತದೆ	ಹ ೋ ಗ ು ತ ್ ತ ದ ೆ |
ಹೋಗುತ್ತಾನೆ	ಹ ೋ ಗ ು ತ ್ ತ ಾ ನ ೆ |
ಹೋಗುತ್ತೇವೆ	ಹ ೋ ಗ ು ತ ್ ತ ೇ ವ ೆ |
ಹೋಗುವ	ಹ ೋ ಗ ು ವ |
ಹೋಗುವುದು	ಹ ೋ ಗ ು ವ ು ದ ು |
ಹೋಗೂ	ಹ ೋ ಗ ೂ |
ಹೋಗೋ	ಹ ೋ ಗ ೋ |
ಹೋಟೇಲಿನ	ಹ ೋ ಟ ೇ ಲ ಿ ನ |
ಹೋದಾಗ	ಹ ೋ ದ ಾ ಗ |
ಹೋಯಿತು	ಹ ೋ ಯ ಿ ತ ು |
ಹೋರಾಟ	ಹ ೋ ರ ಾ ಟ |
ಹೋರಾಡು	ಹ ೋ ರ ಾ ಡ ು |
ಹೋಲಿಸು	ಹ ೋ ಲ ಿ ಸ ು |
ಹೋಶಂಗಾಬಾದ್	ಹ ೋ ಶ ಂ ಗ ಾ ಬ ಾ ದ ್ |
ಹ್ಯಾಗಿದ್ದರೂ	ಹ ್ ಯ ಾ ಗ ಿ ದ ್ ದ ರ ೂ |
